tae-yong|tê dông
brendan|bờ ren đan
blomdahl|lom da
wbc|vê kép bê xê
kinder|kin de
detox|đi tóc
marinos|ma ri no
masterise|mát tơ rai
press|pờ rét
taylor|tây lơ
buffett|bắp phít
vitm|vê i tê mờ 
check-in|chếch in
nano|na nô
australian|ốt sờ trây li ừn
australia|úc
kingfoodmart|kinh phút mát
austrade|ốt sờ chết
taste|tết
sea|si
games|gêm
timor|ti mo
leste|lét te
jason|giây sơn
momoa|mơ mâu a
sistine|sít sờ tin
vatican|va ti căng
covid|cô vít
belarus|bê la rút
mbappe|em ba bê
psg|pi ét di
shophouse|sóp hau
biden|bai đừn
billgates|bin gết 
joe|chô
carnival|các ni van
johnny|giôn ni
depp|đép
amber|am bơ
heard|hét
bts|bi ti ét
kpop|cây bóp
billboard|biu boát
music|miu dích
awards|ơ goát
blackpink|bờ lách pinh
twice|thoai
sticker|sờ tích cơ
california|ca li phóc ni a
nato|na tô
aesthetic|ét the tích
clinic|cờ li ních
h&a|ết chen ây
mjoul|em châu ồ
bbl|bi bi eo
hero|hia râu
forever|pho re vờ
jeff|dép
young|răng
&|en
gas|ga
harvard|ha vớt
washington|goa sinh tơn
john|dôn
kerry|ke li
hotgirl|hót gơn
kremlin|cờ rem lin
mano|ma nô
polking|pôn kinh
indonesia|in đô nê si a
malaysia|ma lay si a
prius|pờ li ớt
techcombank|tếch com banh
top|tóp
asean|a si an
kona|cô na
hyundai|huyn đai
toyota|tô dô ta
wigo|guy gô
honda|hon đa
accord|ơ cót
suzuki|su du ki
vec|vi i xi
putin|pu tin
vladimir|vờ la đi mia
belgorod|beo go lót
moscow|mát cơ va
kiev|ki ép
ufo|u ép ô
erik|e rích
kenya|kê ny a
lego|lê gô
channel|chen nờ
hag|hác
cristiano|cờ rít ti a nô
ronaldo|rô nan đô
man utd|man iu nai tựt
old|âu
trafford|tra phót
dekko|đếch cô
wellness|goeo nít
dojiland|đô di len
diamond|đai mừn
crown|cờ rao
all-in-one|ôn in oăn
all|ôn
video|vi đi ô
ekip|ê kíp
javelin|ra vơ lin
doji|đô di
dubai|đu bai
measurement|me dùa mừn
month|măn
mmm|em em em
virus|vi rút
newcastle|niu cát sờ
arsenal|át sê nan
champions|cham pi ừn
league|lích
mikel|mi keo
arteta|a tê ta
aquaman|a qua men
novak|nô vắc
djokovic|dô cô vích
restaurant|rét tau rừn
anthony|an thô ny
nicky|ních ky
aud|út
andrea|an đờ rê a
richardson|ri chác sơn
grand|gờ ran
slam|sờ lam
greg|gờ réc
rusedski|ru sét ki
ceo|xi i âu
phoenix|phi ních
travel|tra vờ
odessa|ô đe sa
kharkov|kha cốp
ligue|lích
messi|mét si
neymar|nây ma
lionel|li ô neo
vn-index|vi en in đếch
stress|sờ trét
hose|hâu sờ
vn|vi en
pharma|phạc ma
thaiholding|thai hâu đinh
holding|hâu đinh
kursk|cớt sờ
blockchain|bờ lóc chên
debate|đì bết
challenge|cha lừn
swinburne|sờ guyn bơn
sale|sêu
mercedes|méc xe đét
snsd|ét en ét đi
face|phây
kid|kít
hpg|hát pê gờ
stb|ét tê bê
ssi|ét ét i
tcb|tê xê bê
sacombank|sa com banh
premier|pờ ri mi ơ
mohamed|mô ha mét
salah|sa la
azovstal|a dóp sờ ta
mariupol|ma ri iu pun
myanmar|mi an ma
siam|si am
gdp|dê đê pê
pep|pép
guardiola|goắc đi ô la
maria|ma ri a
dele|đê lê
alli|a li
leapmotor|líp mô tô
golf|gôn
james|giêm
franco|phờ ran cô
orlan|ô lừn
donbass|đôn bát
casino|ca si nô
nualphan|nu an phan
lamsam|lam sam
madame|ma đam
kawin|ca guyn
klopp|cờ lốp
liverpool|li vơ pun
southampton|sao tham tơn
city|xi ti
scandal|sờ căng đan
fpt|ép pi ti
arena|a ri na
multimedia|măn ti mê đi ờ
vib|vi ai bi
buv|bi iu vi
9to5mac|nai tu phai mac
airpods|e pót
pro|pờ rồ
paul|pôn
pinbus|pin bớt
ravolution|ra vo lu sừn
festival|phét ti van
dj|đi dây
schooling|sờ cun linh
joseph|dô sép
singapore|sing ga po
f0|ép không
hon thom|hòn thơm
paradise|pa rơ đai
island|ai lừn
iconic|ai co ních
alexander|a lếch san đơ
park|pắc
camera|ca me ra
karaoke|ka ra ô kê
intel|in teo
apple|áp pồ
google|gu gồ
silicon|si li côn
lugansk|lu gen
donetsk|đô nét sích
ocean|âu sừn
vinhomes|vin hôm
smartbiz|sờ mát bít
iot|ai âu ti
internet|in tơ nét
of|ợp
thing|thinh
aercap|e cáp
holdings|hâu đinh
baccarat|bác cơ ra
funimart|phăn ni mát
imessage|ai mét sít
leflair|le phờ le
group|gờ rúp
sopa|sô pa
coo|si âu âu
neil|niêu
patrick|pa trích
harris|ha rít
bidv|bi ai đi vi
laser|la de
zadira|da đi ra
elon|i lừn
musk|mớt
maye|may
illustrated|i lu sờ trây tựt
education|e đu cây sừn
emg|i em di
uci|iu xi ai
irvine|ơ vai
eu|e u
cdc|xi đi xi
syahir|sha hi
bashah|bát sha
denisovans|đe nơ sơ ven
kalachi|ca la chi
sjc|ét di xi
ankara|an ca ra
atlantis|át lan tít
rafael|ra pha en
nadal|na đan
roland|rô lan
garros|ga rốt
mc|em xi
uav|iu ây vi
pantum|pen từm
xtrend|ích tren
gigabyte|gi ga bai
vdo|vi đi âu
server|sơ vơ
enterprise|in tơ pờ rai
consumer|con sum mơ
great|gờ rết
place|pờ lây
work|guốc
gptw|gờ pê tê vê kép
espn|i ét pi en
gabriel|ga bờ ri eo
leading|lít đing
uni|iu ni
media|mê đi a
de jong|đờ dông
frenkie|phờ ranh ki
bmpt|bi em pi ti
philippines|phi líp pin
everest|e vơ rét
vpbank|vi pi banh
online|on lai
clip|cờ líp
massage|mát xa
mrb|mờ rờ bê
hng|ết en di
camille|ca mi
vasquez|vát sờ két
tuscany|tu sờ ca ni
eden|ê đen
garden|ga đừn
global|gờ lâu bồ
homes|hôm
smartbibi|sờ mát bi bi
facebook|phây búc
meta|mê ta
mark|mác
zuckerberg|du ke bớc
swift|sờ guýp
new|niu
pop|póp
fan|phan
vieira|vi ê ra
bulgaria|bun ga ri
eva|ê va
follow|pho lâu
nova|nô va
everton|ê vơ tơn
crystal|cờ rít tồ
palace|pa lết
ict|ai xi ti
unique|u ních
founder|phao đơ
mitsubishi|mít su bi shi
outlander|ao len đơ
apac|a pác
huawei|hua guây
azri|át ri
ghani|ga ni
kit|kít
test|tét
kate|kết
middleton|mít đơ tơn
tom|tôm
cruise|cờ rui
gun|găn
marverick|ma vơ rích
william|guy li am
williams|guy li am
efren|e phờ ren
reyes|ray ét
robbie|rốp bi
cellphones|seo phôn ét
laptop|láp tốp
pc|pi xi
golfer|góp phơ
iran|i ran
amway|am guây
healthy|heo thy
cook|cúc
gameshow|gêm sâu
futsal|phút san
dak|đê a ka
friedrich|phờ ri đờ rích
naumann|nau mừn
foundation|phao đây sừn
fnf|ép nờ ép
aaa|tríp pờ ây
eximbank|e xim banh
ielts|ai eo
speaking|sờ pích kinh
prep|pờ rép
elsa|eo sa
lumiere|lu mi ơ
boulevard|bâu lơ vát
series|sê ri
cosmetic|co sờ me tích
vioedu|vi ô e đu
mythos|my thót
maybach|mây bách
who|vê kép hát ô
cannes|can
idris|i đờ rít
elba|eo ba
cybersex|sai bơ sếch
sex|sếch
gerrard|giê ra
steven|sờ ti vừn
aston|át sờ tơn
villa|vi la
wimbledon|guym bờ đừn
atp|ây ti pi
wta|vê kép ti ây
itf|ai ti ép
future|phiu trờ
blanca|bờ lan ca
blanco|bờ lan cô
kalibr|ca li bơ
iphone|ai phôn
smartphone|sờ mát phôn
idc|ai đi xi
billiards|bi a
will|guyn
smith|sờ mít
rothman|rốt man
sony|so ny
pictures|pích trờ
bad|bét
boys|boi
oscar|ốt sờ ca
vns|vi en ét
juan|hoan
wushu|ủ su
starliner|sờ ta lai nờ
boeing|bô inh
iss|i ét ét
alex|a lếch
ferguson|phê gu sơn
sir|sơ
led|lét
carla|ca la
bruni|bờ ru ni
viktor|vích to
medvedchuk|mét ve chúc
bar|ba
fe|ép e
credit|cờ re đít
smbc|ét em bi xi
brooklyn|bờ rốc lin
romeo|rô me ô
summer|săm mờ
camp|cam
cibes|xai bét
clement|cờ le men
beaune|bon
tottenham|tót tơn ham
norwich|no guých
zelensky|de len sờ ki
volodymyr|vo lo đi mia
europa|ơ rô pa
west|goét
ac|a xê
milan|mi lan
serie|sê ri
sassuolo|sát sua lô
mitsui|mít su i
alcaraz|an ca rát
zverev|de rép
carlos|các lốt
vff|vê ép ép
gaming|gêm minh
watch|goát
kardashian|ca đa si an
kourtney|cót ni
travis|tra vít
barker|bác cơ
italy|i ta li
target|ta gét
tower|thao ờ
antonov|an tô nốp
stem|sờ tem
vaccine|vắc xin
vinamilk|vi na miu
xpander|ích sờ pan đơ
veloz|vê lót
mpv|em pi vi
moskva|mát cơ va
viglacera|vi gờ la xê ra
ajax|a dắc
antony|an tô ni
richter|rích te
easy|i di
trade|trết
msb|em ét bi
tiktok|tích tốc
zalopay|da lô pây
namperfume|nam pơ phum
ifc|ai ép xi
best|bét
digital|đi di tồ
bank|banh
vicem|vi xem
seoul|sê un
spa|sờ pa
power|pao ờ
george|gióc
hormone|hoóc môn
windows|guyn đâu
sergei|sec gây
lavrov|la vơ rốp
otp|ô tê pê
gotec|gô tếch
land|len
officetel|óp phít theo
advantech|ất van tếch
technology|tếch no lơ di
emmy|e mi
rossum|rót sum
radar|ra đa
ralf|ráp
rangnick|rang ních
kenzie|ken di
curran|cơ rừn
selfie|seo phi
montenegro|môn tê nê gờ rô
intercontinental|in tơ con ti nen tồ
residences|re si đừn sít
beach|bích
sydney|sít ni
kiatisuk|ki a ti sắc
harry|ha ri
maguire|ma goai ơ
graeme|gờ ram
souness|su nét
winnie|guyn ni
harlow|ha lâu
ncb|en xi bi
nvb|en vi bi
fsb|ép ét bi
advanced|ất van
minimba|mi ni em bi ây
michigan|mi chi gân
keane|kin
gary|ge ry
neville|ne vồ
rapper|ráp pơ
manor|me nờ
central|xen chờ
babymall|bây bi mo
care|ke
mcmurdo|mác mơ đô
econtract|i con trách
talkshow|thoóc sâu
adriana|a đờ ri a na
catwalk|cát goắc
boris|bô rít
johnson|dôn sơn
dmitry|đi mi tri
peskov|pe sờ cốp
louis|lu ít
legacy|le gờ si
chelsea|chen si
sarmat|sác mát
benzema|ben de ma
real|rê an
madrid|ma rít
ancelotti|an che lốt ti
barcelona|bác xê lô na
alcorest|an cô rét
netflix|nét phờ lích
lask|lát
miss|mít
universe|iu ni vớt
vietnam|việt nam
picasso|pi cát sô
marie|ma ri
thérèse|the rét
walter|goan tơ
software|sóp goe
pub|bắp
bone|bôn
services|sơ vít sít
macrumors|mác ru mồ
brazil|bờ ra xin
london|luân đôn
gojek|gô dếch
light|lai
up|ắp
line|lai
windsor|guyn dờ
nance|nen
like|lai
mekong|mê công
showbiz|sâu bít
penthouse|pen hau
marina|ma ri na
saigon|sài gòn
marriott|ma ri ớt
prudential|pờ ru đen sờ
aqua|a qua
bull|bun
trap|tráp
brighton|bờ rai từn
college|co lít
pfizer|phai dơ
moderna|mo đơn na
mistral|mít sờ trồ
oslo|ô sờ lô
crimea|cờ rai mia
wolfoo|gúp phu
heritage|he rơ tết
lake|lếch
capitaland|kép pi tờ len
propertyguru|pờ ro pơ ti gu ru
mgallery|em ga le ry
shizen|si zen
sharon|sa ron
tate|tết
cambridge|kem bờ rít
brooke|bờ rốc
henderson|hen đơ sơn
open|âu pừn
citizen|xi ti dừn
chechnya|chếch ni a
ramzan|ram dan
kadyrov|cây đi rốp
beatrice|bia trít
gomez|gô mét
georgina|gioóc di na
rodriguez|rô đờ ri guết
texas|tếch dát
direct|đai rếch
selling|seo linh
news|niu
mekophar|mê cô pha
mirror|mi rờ
kasikorn|ca si con
youtube|iu túp
streinz|sờ trên
mauricio|mau ri xi ô
pochettino|pô chét ti nô
kindergarten|kin đơ ga từn
samsung|sam sung
galaxy|ga la xi
beverly|be vơ ly
solari|sô la ri
blend|bờ len
secret|si cờ rét
valley|va li
kylie|kai li
jenner|de nơ
rihhana|ri a na
queen|quyn
mazda|mát đa
vision|vi dừn
touch|toóc
violympic|vi ô lim bích
sms|ét em ét
banking|banh kinh
vietcombank|việt com banh
vat|vát
gen|den
podcast|pốt cát
spotify|sờ po ti phai
vbiz|vi bít
ocb|ô xê bê
rocky|rốc ki
playboy|pờ lây boi
ashley|át li
harkleroad|hác lơ rốt
intelligence|in te li dừn
research|ri sớt
partners|pát nơ
dortmund|đót mun
borussia|bo rút si a
bayern|bay ơn
munich|miu ních
bundesliga|bun đét li ga
derby|đơ bi
merseyside|mơ si sai
jackpot|dách pót
delmar|đeo ma
pellio|pe li ô
emirates|e mi rết
mctominay|mác tô mi nây
scholes|sờ côn
bitcoin|bít coi
tiktoker|tíc tốc cơ
sugar|su gờ
bayby|bây bi
daddy|đát đi
livestream|lai sờ chim
victoria|vích to ri a
darren|đe ren
barnet|ba nét
live|lai
concert|con sớt
taisei|tai sây
tribe|trai
resort|rì sọt
lithuania|lít va
baltic|ban tích
kaliningrad|ca li nin gờ rát
world|gua
scott|sờ cốt
morrison|mo ri sơn
solomon|sô lô môn
lee|li
foss|phót
schallenberg|sa len bớc
macron|ma cờ rôn
emmanuel|i ma nu eo
marine|mơ rin
vallecano|vai e ca nô
lampard|lam pát
fed|phét
kols|cây âu eo s
kol|cây âu eo
communications|com miu ni cây sừn
gapit|gáp pít
mcredit|em cờ re đít
mason|mây sơn
holgate|hôn gết
stuart|sờ tu át
attwell|át goeo
vinfast|vin phát
motors|mô tô
israel|ít sa ren
liga|li ga
sevilla|se vi la
atletico|a le ti co
mallorca|ma lo ca
fc|ép xê
turkish|tơ kít
airlines|e lai
euroleague|e ro lích
play|pờ lay
kyle|kai lơ
gordy|go đi
valery|va le ri
gerasimov|ghê ra si mốp
miranda|mi ran da
kerr|cơ
evan|ê van
spiegel|sờ pích gờ
met|mét
gala|ga la
covid-19|cô vít mười chín
afc|a ép xê
phillipe|phi li pe
auguste|au gớt
ninja|nin gia
usd|u ét đê
ounce|au
utd|u
brentford|ren pho
roy|roi
c.ronaldo|rô nan đô
hill|hiu
ntk|en ti cây
uefa|uây pha
euro|ơ rô
rocket|róc két
lab|láp
jurgen|du ghen
villarreal|vi la reo
marilyn|	ma di lyn
monroe|mun rô
mike|mai
tyson|tai sơn
taxi|tắc xi
a73|a bảy ba
a53|a năm ba
a3|a ba
amoled|a mô lét
pakistan|pa kít sờ tan
ill|iu
rap|ráp
angelina|an giê li na
jolie|giô li
lisa|li gia
bonet|bo nét
oda|ô đa
uss|u ét ét
u23|u hai ba
shin|sin
tae|tê
yong|dong
kaopiz|pi
consulting|con su ting
partner|pát nờ
aws|ót
apn|a pê nờ
chin-su|chin su
calleja|ca lê gia
jardin|dát đin
villas|vi la
stellars|te la
sonkim|son kim
snap|sờ náp
brabus|bơ ra bít
mercedes-maybach|méc xe đéc may bách
gls|gờ lờ ét sờ
monfils|mon phin sờ
serbia|xéc bi
moss|mót
lila|li la
mil|mi
vietravel|việt tra vờ
millennials|mi len ni a
coteccons|cô tếch con
make|mếch
lumi|lu mi
robocon|ro bo con
smarthome|sờ mát hôm
jonathan|dô na than
goodwin|gút gờ uyn
america's|a mê ri ca ích
america|a mê ri ca
got|gót
talent|ta lần
mv|em vi
denali|de na li
green|gờ rin
gragon|ra gon
dragon|đờ ra gần
phenobarbital|phe no ba bi ta
warren|goa ren
lock|lóc 
iccid|i cê xê i đê
thylane|thy lan
blondeau|bê lon dê au
bird|bớt
nutrinest|nút ri ne
chanathip|cha na thíp
vimedimex|vi me đi me
asian|ây si an
cup|cúp
brilliant|bờ ri li ừn
doctor|đốc tờ
sharp|sáp
agrico|ơ gờ ri cô
songkrasin|xong cờ ran xin
kawasaki|ca goa sa ki
guangzhou|gang hu
frontale|ron ta le
crimson|cờ rim sờn
face-off|a cê e của ép ép
chris|cờ rít
rock|rốc
bill|biu
gates|gết
metlife|mét lai phờ
fortuner|pho tun nơ
jbl|j bê lờ
lfp|lờ ép pê
misa|mi sa
meinvoice|mê in voi
invoice|in voi
cic|xích
invest|in vét
luxury|lắc xơ ri
fabio|pha bi ô
magrao|ma rao
julia|du li a
galef|ga lép
melinda|mê lin đa
french|phờ ren
olivia|ô li vi a
culpo|cu bo
instagram|in sờ ta gờ ram
shopee|sóp pi
qatar|ca ta
mary|ma ri
jane|dên
spider-man|sờ phai đơ men
molnupiravir|mo nu pi ra vi
roma|rô ma
as|ét
leicester|lét sờ tơ
conference|con phờ rần
mourinho|mô ri nhô
uniben|u ni ben
viettel|việt theo
store|sờ to
tiffany|típ pha ni
trump|trăm
donald|đô nan
sapphire|sa phia
mansions|man si on
moca|mo ca
limestone|li me to ne
ahome|a ho me
frankfurt|phơ gianh phớt
vassily|va si ly
nebenzia|nê bên zi a
melissa|mê li sa
gilbert|gin bớt
alexandra|a lếch xan đờ ra
david|đa vít
moyes|moi
kickboxing|kích bốc xing
x-quang|x quang
oasis|o a xít
buakaw|bua ca
banchamek|ban cha me
tropical|cho pi cồ
sienna|si ê na
miller|mi lơ
oli|ô li
evnnpc|e vê nờ nờ pê xê
para|pa ra
made|mết
sunhouse|săn hau sờ
hotels|hô theo
resorts|ri sót
airbus|e bớt
onehousing|oăn ne sinh
proptech|gióp
masan|ma san
vulcano|vun ca nô
collection|cô lếch sừn
change|chênh
your|gio
style|xì tai
life|lai phơ
cuba|cu ba
havana|ha va a
saratoga|xê ra tô ga
abramovich|a bờ ra mô vích
todd|tát
boehly|bo e ly
sports|sờ pót
center|xen tờ
casa|ca sa
choi|choi
jin|din
joon|giun
hee|hi
xiaomi|xi ao mi
canalys|ca nao ợt
hye|hai
norman|no mần
fegidero|phe gi de ro
stephan|sờ te phan
schrock|róc
fury|phu di
jack|dắc
alibaba|a li ba ba
nigeria|ni giê ri a
zealand|di lân
katharine|ha rin ne
mcphee|phe 
alica|a li ca
schmidt|sờ mít
tpbank|tê pê banh
vnpay|vê nờ bay
yuka|ka
saso|sa sô
lockheed|lóc hít
martin|mát tin
canada|ca na đa
tedx|tét
tedxđakao|te đa
bid|bít
residence|re di đần
peek|píc
performance|pơ phom mần
nuanphan|phan
kienlongbank|kiên long banh
evergrande|e vơ gờ ranh
bloomberg|bờ lum bớt
trojan|trâu dần
spyware|sờ pai guoe
rootkit|rút kít
adware|át guoe
taliban|ta li ban
afghanistan|áp gan nít tan
fdi|ép đê i
copa|cốp pa
ivanka|i van ca
shipper|síp pơ 
kentucky|cen tắc ki
nice|nai
rostec|rót sơ tếch
checkmate|chếch ma te 
jamaica|gia mai ca
olympic|ô lim píc 
laine|e lên
thompson|thom sơn
herah|hê ra
leon|li on
black|bờ lách 
guzel|gu den
ganieva|gan ni e va
tiqui|ti qui
taka|ta ca
furia|phu ri a
roja|rô ra
manchester|man chét tơ
lukaku|lu ca cu 
cerezo|xi re rô 
osaka|ô sa ca
kabul|ca bun
akira|a ki ra 
nishino|ni si nô
fat|phát
heung|hi ung
evncpc|i vi en xi pi xi 
biontech|bi on 
kim|kim
paris|pa ri
hilton|hin tơn 
britney|bờ rít nia
spears|sờ pia
cacao|ca cao
expo|ếch pô
panjshir|pan hi
ahmad|a hơ mát
massoud|mát sao
filip|phi líp 
slovan|lo van
liberec|li be réc
hms|ết em ét 
defender|đì phen đơ 
sars-cov-2|sác cô vi hai
matt|mát
hancock|han cóc
robot|rô bốt 
cobot|co bê ô tê
wefinex|ép fi ne
faisal|phai san 
ahmed|a mét
olympia|ô lim pi a
post|pốt
unai|u nai
simon|sai mơn
vinpearl|vin pơn 
flash|phờ lát
voucher|vao chờ
tesla|tét la
toefl|tóp phồ
omicron|o ron 
delta|đen ta
ecuador|ê cua a đo 
jasmine|dát mai
tookes|to ce
borrero|bo re ro
alfredo|an phê đo
connor|con nờ 
fields|phiêu
leanne|le an ne
carr|ca 
lincolnshire|lin con hi re
titane|ti tan ne
jay|giây
phillips|phi líp
shadowloss|sa do lo 
shb|ét hát bê 
supachok|su pa chốc 
mi1|mờ i một
paxlovid|pa lo vi 
merck|me
co's|cót ét 
ridgeback|ri bắc 
biotherapeutics|bi ót he ra 
gede|de 
ulsan|u san 
kaya|ka da
app|áp
haiti|hai ti 
martine|mát tin
jovenel|dô ven ne
moise|moi xe 
covax|cô vắc
ilo|ai eo ô 
vama|va ma
doping|đô bing
naris|na ri
japan|dơ pen
parasola|pa ra so la
solskjaer|sôn cai ơ
bolivia|bô li vi a 
monumental|mo num men ta
reuters|roi tơ
influencer|in lu en
l'équipe|lơ qui pe
phnom|phờ nôm
penh|pênh
campuchia|cam pu chia
happynest|háp py ne
coway|co ay
vina|vi na
brisbane|bờ ri ban
dezeen|de de en
saudi|sau đi
arabia|a ra bi a
pogba|pô ba
leeds|lít
sedan|sê đan
rodgers|rốt dờ
amazon|a ma dôn
totoro|to to ro
t-rex|tê rếch
velociraptors|ve lo ráp to
chatchai|chát chai
petrovietnam|pê trô việt nam
container|công ten nơ
astrazeneca|a tra den ne ca
oh|ô
kyun|ki un
poker|póc cơ
seattle|sét tồ
hoia|hoi i
baciu|ba 
romania|ru man ni
uttar|u ta
pradesh|pơ ra đét
fair|phe
high|hai
amsterdam|am sờ tét đam
uzbekítan|u be kí tan
uzbekistan|u rơ bê kít tan
k-icm|cây ai xi em
tci|ti xi ai
phaco|pha cô
seungri|se ung ri 
big|bích
first|phớt
flc|ép lờ xê
plông|lông
liveshow|lai sâu 
show|sâu
g.ducky|gờ dúc ci
turkmenistan|tuốc mê ni tan
adisak|a đi sắc 
kraisorn|rai so
torbjorn|to do
faptv|pháp ti vi 
hack|hách
logo|lô gô
game|gêm
mexico|mê xi cô
fado|pha do
market|mắc kít
metro|mê trô
sonnet|son nét 
wyndham|guyn dừm 
legend|le gùn
halong|hạ long 
forward|pho guốt
natasha|na ta sa 
bassett|ba sít
st tropez|ét tê tro pe
el|eo
facetime|phây tham
guide|gai đờ
vas|vát
manilla|man ni la
vingroup|vin gờ rúp
vinschool|vin 
beckham|béc khăm
reeva|re e va
topping|tóp pinh
seoers|seo e
cares|ke
rafale|ra phôn
jong|dong
medic|me
skin|sờ kin
clear|cờ lia 
fv|ép vê
aff|a ép ép
steroid|sờ tê roi
excel|ích xeo 
english|inh lích 
with|guýt 
ola|ô la 
seabank|si banh 
basel|bây den 
ssb|ét ét bi
imf|ai em ép
esport|i sờ pót
petrolimex|pê trô li mếch
suih|sui
pepsi|pép si 
suntory|săn to ri
pepsico|pép si cô
lipovitan|li po vi tan
tongkat|tong
ali|a li
nine|nai
evnhcmc|e vê nờ hát xê mờ xê
christine|cờ rít ti 
lagarde|la ga de
brad|bờ rét  
maloney|ma lo
mcenroe|rô e
horea|ho re a
international|in tơ ne sừn nồ
kristen|cờ rít từn 
marq|ma
graovac|dao vác
nathan|na than 
ming-chi|minh, chi
kuo|ku ô 
erling|e
haaland|ha lan
deloitte|di lô ích
hokkaido|hốc kai đô
accent|ác xen
gruzia|gờ ru dia 
ossetia|o sét ti a
stefanos|tép phan no
tsitsipas|tít si pa
amser|am sơ 
ams|am
profile|pờ rô phai
ambassador|am ba sa
cbs|xê bê ét
fbi|ép bê i
ertiga|ơ ti ga
emily|em mi li
robb|rốp
ford|pho 
hybrid|hai bờ rít
zaporozhye|ra po ro hi e
zaporizhia|ra po ri hi a
sorento|so ren tô
mesut|me sút
ozil|ô din
bush|bút sừ 
fpt.ai|ép pi ti ây ai
chosun|chô sun
lithium-ion|li thi um, i ông
vpop|vi póp
pataky|pa ta ky 
thor|tho
kherson|ke son
hemsworth|hem sừ guốt
bryson|ry son
dechambeau|de cham be
memorial|mem mo ri ồ 
tournament|tua nờ mần
pang|păng
feyenoord|phây ây nót
jose|dô sơ
kombetare|be ta re
albania|an ban ni
euthalia|tha li a
bankman-fried|ban man ri e
tie-break|tai, bờ rếch
university|iu ni vơ xi ti
richmond|rích măng
worrawoot|o ra ót
srimaka|ri ma ka
yannick|dan ních
nusbaum|bu bau 
marcel|mắc xep 
sieghart|si e
himalaya|hi ma lay a
spike|sờ pai
ipef|i pê e ép
yeremia|y e re mi a
rambitan|ram bi tan
marcus|ma cớt 
rashford|ra phót
irma|i ma 
garcia|gác xia 
jaxtina|gia ti na
goodfellas|go phe la
dominica|đô mi ni ca
liotta|li ót ta
gareth|ga rét 
bale|bêu
carlo|các lô
abba|a bê bê a
voyage|voi ết
rian|ri an
akhmetov|át mi tốp
keisuke|su ke 
v-league|vi lích
thai-league|thái lích
n.t.v.h|nờ tê vê hát
karim|ka rim
m-tp|em ti pi
chongqing|chong ching
liangjiang|li ang di ang
northrop|nóp róp
grumman|gờ ru man
raider|rây đờ
ipad|ai pát
ipados|i pê át ô ét
conjuring|con du
petro|pê trô 
poroshenko|po rô sen kô 
yeah1|y a
lamborghini|lam bô gin ni
olaf|ô láp
scholz|cho
sievierodonetsk|si e vi e ro do nét
lyman|li man
lg|eo di
puricare|pu ri ca re
ye|di 
hyun|hy un
torres|to rét
paula|pau la
batet|ba tét
burns|bơn
scottie|cót ti e
scheffler|chét le
play-off|pờ lây ọp
charles|chắc lờ 
schwab|soáp
ishcmc|in tơ ne sừn nồ hồ chí minh xi ti
gustafsson|gu táp son
marketplace|mắc két pờ lên
nft|nờ ép tê
passport|pát pót
openlive|o pen li ve
hp|hát pê
website|goép sai
royal|roi ồ
robert|rô bớt
lewandowski|lê goan dô ki
ion|i on
home|hôm
tangmo|tang mo
nida|ni da
venezia|ve ne ri a
homeresort|hôm re so
ediacaran|e di a ca ran
twitter|chuýt tơ
filler|phin lơ
yolo|dô lô
godsaeng|go sa eng 
macbook|mac búc
ottawa|ốt ta oa
wook|gút
donga|đông á
severodonetsk|se ve ro do nét
airasia|e ra si a
kuala|ku la 
lumpur|lăm pua
together|to ge dờ
kinzhal|kin ha
mako|mắc cô
monte|môn tê 
word|guốt
powerpivot|po e pi vót
powerbi|po e vi
evnhanoi|e vê nờ hát a nờ ô i
lumos|lu mo
marketing|ma két tinh
atc|a ti ci
sri|sờ ri
lanka|lan ca
red|rét 
flag|phờ lác
index|in đếch
living|li vinh 
mall|mo
sofa|sô pha
youtuber|y tu be
footmercato|phót me ga to
leonardo|le ô nát đô 
tms|ti em ét
ruby|ru bi
interceptor|in te to
coca-cola|cô ca cô la
cleanup|cờ lin ắp
pegatron|pê ga trông
bernabeu|béc na bêu
gelex|ge lếch
cowell|cô goeo
lauren|lau ren
silverman|si vơ man
bluechips|bờ lu chíp
frank-walter|phơ ranh goan tơ
steinmeier|tanh mơ e
jrai|dai
disney|đít ni
icankid|i can ki
athletic|a thờ le tích
erickson|e son 
lubin|lu bin
pisa|pi sa
tcc|tê xê xê
ferromin|phe ro min 
vitamin|vi ta min
ds-group|dê ét gờ rúp
newstarland|ne ta lan
property|pờ ro pơ ti
olena|o len na 
zelenska|re len ka
times|tham
rambo|ram bô
jetking|dét kinh
nabil|ba biu 
sgc|ét gờ xê
bourassi|ra si
tribune|tri bun 
sky|sừ cai 
realty|riêu ti 
hillside|hi si de 
jeju|de du
pachinko|pa chin 
economic|e cô nô míc
cneconomy|ci en e cô nô mi 
peak|pích 
manhattan|man hát tan
paday|pa day
elie|e li 
saab|sáp 
haute|hau tơ 
couture|cu trờ
combo|côm bô
liz|li 
hurley|hơ li
viagra|vi a gờ ra
jair|ra 
bolsonaro|bo son ra ro
natalie|na ta li
glebova|le bo va
roadshow|rót sâu
brian|bơ ri an
benjamin|ben da min
block|bờ lốc 
iraq|i rắc
epic|e píc 
traveloka|tra vờ lâu cờ
accor|ơ co 
melia|mê li a
toilet|toa lét
androgen|an rô gen
filmore|phi mo re
openasia|o pen na si a
simeone|si mi ôn nê
diego|đi ê gô
saint|sanh 
germain|gơ mên
khobsanam|kho sa nam
surprise|sắp pờ rai
ferrero|phơ rơ rô
chocolate|chô cô lết
alexa|a lê xa
paget|pa dét
wifi|goai phai
kei|kây
komuro|kô mu rô
alec|a lếch
baldwin|ban guyn
career|ca ri
senamuang|se ba
vsip|vê ét i pê
panasonic|pa na sô níc
fda|ép đê a
cholimex|cô li mếch
licogi|li co di
cmf|xê mờ ép 
l14|lờ mười bốn
titan24|ti tan hai mươi tư
poppy|póp py
evans|i van sờ
shandong|san đông
taishan|tai han
generali|den na ra li
haojin|hao din
johor|do ha
darul|đa du
ta'zim|ta dét i mờ
botox|bô tóc
basedow|ba se do
yokohama|ô kô ha ma
sputnik|sơ pu ni
mykolaiv|mi lai
habitat|ha bi tát
sembcorp|sem cóp
gateway|gét guây
vsg|vi ét di
swing|sờ guynh
for|pho
kids|kít
hyori|hi ô ri
afp|a ép pê 
conor|co nờ
mcgregor|mắc gờ re go 
marathon|ma ra tông 
half|háp
sandara|san da ra
coachella|cô che lờ
hemangiosarcoma|he ma sa co ma
angiosarcoma|ang sa co ma
biz|bít
asahi|a sa hi
hotelier|hau teo lờ
savills|sa vin
branded|ran
arminia|a mi ni a 
bielefeld|bi li pheo
ipswich|ai pi sờ guých
town|thao
one|oăn
elkan|e 
baggott|ba gót 
alisa|a li sa 
lenin|lê nin
fadil|pha đin
morning|mo ning
brio|bờ ri o
topzone|tốp don ne
f88|ép tám tám
honey|hon ni
national|na xừn nồ
geographic|gi ô gờ pháp phích
learning|lơn ninh
oxford|óc phớt
jackson|giắc sờn
wang|gu oang
ramai|ra mai
rumakiek|ru ma ki e
2ne1|hai nờ e một
steinway|sờ tên guây
emma|em ma
jones|dôn
hat-trick|hát trích
agribank|a gờ ri banh
cadiz|ca di
nou|nu
bayan|ba dan
resources|re
china|chai nờ
eastern|ít sờ tơn
dusan|đu san
vlahovic|vờ la hô vích
carolina|ca rô lai na
stramare|sờ tram me
megan|me gan
fox|phoóc
pvcombank|pi vi com banh
vemanti|vê man ti
del|đeo
potro|pốt trô
lucien|lu sưn
laviscount|la vít cao
off|ọp
unlock|ăn lóc
dream|đờ rim
signify|sích nơ phai
etax|i tắc
mobile|mô bai
hanwha|han goa
vietinbank|việt tin banh
oman|ô man
tammy|ta my
abraham|ây bờ ra ham
leah|li a
mcdonald's|mác đo nồ
charm|cham
sound|sao
biss|bít
brand|bờ ran
umail|iu meo
email|i meo
carillon|ke rơ lon
riverfront|ri vơ phờ ron
adrien|ây đờ ri en
brody|bờ râu đi
pianist|pi a nít
sunny|săn ni
neyleen|nai lin
carbon|các bon
spielberg|sờ pi eo bớc
squid|sờ quýt
air|e
gulfstream|gấp sờ trim
capella|ca pe la
opel|âu pồ
nelly|ne li
korda|cô đa
major|mây dờ
tour|tua
madeleine|ma đe lin
albright|ô bờ rai
nail|nêu
polytechnic|pô li tếch ních
academy|ơ ca đe my
eurosport|ơ rô sờ pót
corretja|cô rét da
drama|dờ ram ma
pearl|pơ
vinbigdata|vin bích đa ta
vinfuture|vin phiu trờ
vogue|vốc
clubhouse|cờ lắp hao
sailing|seo linh
heroin|hê rô in
koffman|cóp men
caravan|ke rơ ven
uae|u a e
nanogen|na nô gien
gci|gờ xê i
four|pho
paws|po
vietbuild|việt biu
aseanwindow|a si an guyn đâu
khloe|cờ lâu i
maralee|me rơ li
nichols|ních cồ
tristan|trít sờ từn
eugenie|iu gien ni
bouchard|bu chát
nepal|nê pan
bangkok|băng cốc
phillip|phi líp
roller|rôn lơ
chaowat|chao goát
wirachat|guy ra chát
dewey|đu i
mount|mao
vernon|vơ nừn
mancini|man chi ni
roberto|rô bớt tô
macedonia|ma xê đô ni a
titanic|tai ten ních
brussels|bờ rúc xen
redmi|rét mi
note|nốt
gb|gi ga bai
inbound|in bao
croatia|cờ roát chi a
entertainment|en tơ tên mừn
ferrari|phe ra ri
suv|ét iu vi
purosangue|pu rô sang gue
usaid|iu sết
unicef|iu ni sép
kosy|cô si
freeform|phờ ri phom
argentina|ác hen ti na
venezuela|vê nê duê la
gtv|gờ tê vê
icom|ai com
supercup|súp pơ cúp
star|sờ ta
arianny|a ri a ni
celeste|xe lét
apec|a pếch
adn|ây đi en
eriksen|e rích sen
christian|cờ rít chừn
rachael|rây chơ
blackmore|bờ lách mo
suriname|su ri nam
sonntag|son tác
audemars|o đơ ma
piguet|pơ guây
schoolrank|sờ cun ranh
race|rây
kingsmith|kinh sờ mít
king|kinh
solution|sô lu sừn
foo|phu
fighters|phai tờ
hawkins|ho kin
colombia|cô lôm bi a
kanye|ca ni ê
developer|đi ve lốp pơ
dicaprio|đi ca pờ ri ô
amy|ây mi
schumer|su mơ
takefusa|ta két phu sa
kubo|ku bo
fritz|phờ rít
racing|rây xinh
kick-off|kích ọp
madam|ma đam
port|pót
berkshire|bớc sai
hathaway|ha tha guây 
congo|công gô
mister|mít tơ
auckland|âu cờ len
puerto|pu ớt tô
rico|ri cô 
house|hau 
cabin|ca bin 
thuduc|thu dúc
huang|hoang 
xilian|xi li an 
sulu|su lu
manila|man ni la
mino|mi nô
ibrahimovic|i bờ ra hi mô vích
pcr|pê xê rờ
smart|sờ mát 
jac|giắc
zebra|de ra 
technologies|tếch nô lô di 
picenza|pi ra 
riverside|ri vơ sai
tapuho|ta pu ho 
fibo|phi bo 
capital|cáp pi tồ 
tnt|ti en ti
doyose|do sê 
regal|ri gờ 
maison|mai sơn 
aitsaret|sa rét 
noichaiboon|noi chai bon
supasan|su pa san 
sandra|san đờ ra 
bullock|bu lóc
alkhereiji|a khê di
aguttes|a gút te
ezviz|e rét vê i rét
pasteur|pát tơ
lenovo|lê nô vô 
ideapad|ai đia pét
slim|sờ lim 
amd|a mờ đê
bizverse|bi ve se 
indian|in đi ờm 
wells|goeo
medvedev|mét vơ đét
gael|ga e
daniil|da
view|viu
earth|ớt
sunnews|sun ne
meyhomes|ho me 
daewoo|dai u
e&c|e và xê
frozen|phờ lâu rừn
sierra|si ê ra 
leone|lê ôn
picomat|pi co mát
slovenia|sờ lô vê ni a
sudan|su đăng
tropicana|tro pi ca na
teen|tin
dick|đích 
dyke|di ke 
arlene|ác lin
silver|sin vờ
hamubay|ha mu bay
eduten|e du ten
sergey|séc gây 
kitty|kít ti 
hawk|hác
tuchel|tui xen 
middlesbrough|mít lét bờ ru
momo|mô mô 
chernigov|chen ni go
nas|nát 
boundless|le
vinshop|vin hóp 
jae|dê
bmw|bê mờ vê 
mercedes-benz|méc xe đéc ben 
eqs|e quy ét
benz|ben
juventus|du ven tút 
petrovic|pét ro
midcap|mít cáp  
penny|pen ni
krishnamurti|ri na mu ti
bezos|bê dô
soleimani|sô lê ma ni
vnđ|việt nam đồng
kane|kên 
wayne|guây nơ
rooney|run ni  
anton|an tông 
siluanov|si lu no
rick|rích 
karolina|ka rô li na
bielawska|bi e la ka
thelink|the lin 
ciputra|xi pu tra
porsche|pót chờ
cayenne|cai en
protein|pờ rô tê in
ship|síp
trend|tren 
vilico|vi li co
gtnfoods|pho
transfermarkt|tran phơ mác
cheerball|che e ba
startup|sờ tát ắp
stringee|tri e
hpv|hát pê vê
vios|vai ớt
jadon|da don 
sancho|san cho
southgate|ga te
okezone|o ke ro ne
yace|da
ios|ai ô ét
wallace|gua lết
denis|đen nít 
shmygal|mi ga
magdalene|ma da le ne
antonio|an tô ni ô
canova|ca no va
edition|i đi sừn
sba|ét bi ây
adriano|éc ri an nô 
rossiya|rốt si a
usac|u ét a xê 
chiropractic|chi róp rác
girl|gơn
hot|hót
electeka|e lếch te ka
tech|tách
cisco|xít cô
rihanna|ri an na
daniel|đan ni en 
radcliffe|rác cờ lít 
potter|pót tơ 
seri|sê ri
tik|tê i ka 
tok|tốc
boxing|bốc sinh
kitidech|ki ti 
hirunsuk|hi run su
wba|vê kép bê a
t-cross|tê, cờ rót
peugeot|pi re ót 
seltos|se to
ziyech|di
embassy|em ba si 
north|nót 
collegiate|co li dịt
food|phút 
recuse|re cu se
danny|đan ni
murphy|mơ phi 
fifa|phi pha
sohu|sô hu
jean|din
corolla|cô rô la 
altis|a tít 
vtv|vê tê vê
andrey|an đờ rây 
paliy|pa
fiesta|phi ét ta
jennifer|den ni phơ  
lopez|lô pét 
affleck|áp lét
uncle|un le 
fatty|pha ti
poongodu|pong go du
yamaha|da ma ha 
motor|mô tô
cross|cơ rót
camry|cam ri
attrage|át rai 
nissan|nít san
almera|a me ra
cruz|cờ rút
fansie|phan si e
pijika|pi di ka
bunkwang|bu nang
forbes|phót
transit|tran sít
wineco|in e cô
winmart|in mát
feria|phe ri a
đắk|đắc
lắk|lắc
jotun|dốt tun
vento|ven to
asia|ây si ờ
gem|ghem
soccer|sóc xơ
meghan|mê gan
markle|mắc cô
guardian|gát đi an
kidong|ki dông
chernobyl|chờ nâu bồ
voronezh|vo do ne
bellator|be la to
championships|chem pần síp
ford explorer|pho ích pờ lo ờ
royal's|ro da ét
truth|chu
cap padaran|cáp pa da dan
nova consumer|no va cần dum mơ
novagroup|no va gờ rúp
aeroflot|ê rô phờ lốt
salvador|san va đo
hatchback|hát bách
bruno|bờ ru nô
fernandes|phơ nan đét
loyal|loi ờ
wingman|guynh men
pirelli|pơ re li
angelababy|an giê la bây bi
biogas|bi ô ga
jura|du ra
gil|giu
dcomics|đi co mích
francisco|phờ ran sít cô
stylist|sờ tai lít
aubameyang|âu ba mây ang
pierre|pi e
emerick|e mơ rích
justin|chớt sờ tin
trudeau|tru đau
lizzie|li di
greenwood|gờ rin út
buffet|bắp phét
cahill|cây hiu
jesse|chét si
lingard|linh gát
webometrics|góep bô me trích
scotland|sờ cót lừn
cox|coóc
harold|he râu
varner|van nơ
plus|pờ lớt
homo|hô mô
sapiens|sây pi iền
spirit|sờ pi rít
ecstasy|ếch sờ tơ si
rolls|rôn
royce|roi
dean|đin
terry|te ri
durling|đơ linh
herron|he rừn
turner|tơn nờ
bobtail|bóp thêu
analog|a na loóc
lille|liu 
morocco|ma rốc
johannesburg|chô hen nét bớc
juliane|chu li an
seyfart|xây phạt
transerco|tran sê cô
bluezone|bờ lu dôn
insider|in sai đờ
burnley|bơn li
spruce|sờ pờ ru
pool|pun
bonsai|bon sai
bamboo|bam bu
abbank|a bê banh
development|đi vi lốp mừn
deadline|đét lai
valencia|va len xi a
polo|pô lô
havard|ha vớt
sun|sun
gangnam|gang nam
psy|pi
that|dát
cmapuchia|căm pu chia
ukraine|u cờ rai na
donets|do nét
alexandre|a lếch san đe 
michael|mai cơn
weiss|uây
imperium|im pe riu 
malloca|ma lo ca
toray|to rai
at|ét
viengkham|vi en kham
charlie|chác li
jaclyn|giác 
caribbean|ca ri bê
pulitzer|pu lít dơ 
canxi|can xi
kader|ka de 
arby|a bi
halima|ha li ma 
cisse|se
hailey|hai
bieber|bia bơ
faros|pha rốt
ros|rốt
simona|si mô na
heights|hết
lagrange|la rang
elasten|e lờ a ét tê e nờ
velizar|ve li da 
popov|po pâu
grealish|cờ de lít
ekin-su|ê kin su 
culculoglu|cu cu lo lu
oppo|óp pồ
realme|riu mi 
kop|cốp
peter|pi tơ 
shelton|seo tơn
opec|ô pếch
farmstay|pha tay
ecovalley|e cô va lây
calum|ca lum 
moger|mo 
fabinho|pha bi nho 
koja mart|cô da mát
ipod|ai pót
vietnamobile|việt nam mô bai
twenty|en ti 
five|phai
hospitality|hót pi ta li ty
celta vigo|xeo ta vi gô 
ronald|rô nan 
araujo|a rau dâu
kurash|ku rát
boehringer|bo e ri 
ingelheim|gi
sarah|sa ra 
hooper|hóp pe 
taormina|tao mi na
madame pang|ma đam pang
elie saab|e li sáp
starstreak|sờ ta trê a
mompha|mom pha 
junior|du ni ô
aramco|a ram cô 
strange|sờ trên
multiverse|mun ti vét sét 
madness|mét 
tibet|ti bét 
bayer|bây ơ
routine|ti ne 
start|sờ tát 
xperia|ích pơ ri a
happy|hép pi
day|dây 
mediamart|mê đi a mác
eva mendes|ê va men đét
hollywood|hô ly út
theon|the on
tracy|trây xi 
lux|lắc 
beauty|biu ty
hercules|hê cu le
syria|xi ri 
qualcomm|quan com
suk|súc
range|rên giơ 
rover|râu vơ 
sport|sờ pót
iceland|ai xơ len
jimmii|dim 
lengkeng|leng keng
homestay|hôm sờ tây
kendall|ken đồ 
display|đít pờ play 
eleganz|ê lê gan 
furniture|phơ ni chờ
shinhan|sin han 
conte|côn tê
antoinio|an tô ni ô 
yilong|long
gazprom|ga zơ pờ rôm
vienna|viên
rome|rô ma
masters|mát tờ 
felix|phi líc
auger-aliassime|au a li a si me 
casper|cát pơ 
ruud|rút
premium|pờ re mi ùm 
goo|gâu 
kyo|ki ô
album|an bum
qs|quy ét 
stars|sờ ta
certificate|sơ ti phi cết
award|ơ guốt 
ceremony|sơ re mo ni
free|phờ ri 
eyes|ai
jpmorgan|dây pi mô gan 
chase|chây
honda|hon đa
collagen|cô la gien
dr.marie|dê rờ ma ri
mom|mom
dad|đét
canifa|ca níp ha
buffalo|búp pha lô
winslet|uyn sờ lét
threapleton|re ắp le ton 
ruth|rút 
fa|pha
soyeon|so on
incheon|in chen on
straitstimes|sờ trết tham 
ava|a va 
michelle|mi sen 
tira|ti ra 
buyanee|bu dan ne e 
kittikorn|kít ti 
lotte|lót te 
seok|seo 
joo|du 
showroom|sâu rum 
boncha|bê o nờ xê hát a
avanza|a van da 
west ham|goét ham 
psyche|shi che 
pencak|pen cát 
silat|shi lát 
selangor|se len go 
federer|phe đê rơ 
nasa|na sa 
hataoka|ha tao ka 
vconnex|con ne
vinid|vin ít 
iskander|íc ken đơ 
mellow|me lo 
nature|nây trờ 
bridge|bờ rít 
vk|vê ka 
frontier|phờ ron ti ơ 
egy|éc 
maulana|mau la na 
witan|guýt tần 
sulaeman|su lai man 
fk|ep ka 
senica|se ni ca
slovakia|sờ lô va ki a 
jacob|dây cốp 
mahler|ma lê 
doja|do da  
cat|két 
grammy|gờ ram my
vincom|vin com
jeonbuk|dôn bớt
corex|cô reo 
tricc|tê rờ i xê xê 
berlin|béc lin 
bolat|bô lát 
duisenov|du se noi 
koons kia|kia 
moldova|môn đô va 
transnistria|tran ni tri a 
chibest|chi be 
trendy|tren di 
kritenbrink|ten bờ rin 
eduardo|e đu a đo 
elenilson|e len ni son 
gama|ga ma 
caucaia|cau cai a 
moody's|mo di ét
parag|pa ra
agrawal|a ra oa 
karose|ka ro se 
ursula|u su la 
der|đờ
leyen|le 
aia|ai a 
vinmec|vin mớt
empire|em pai 
pratama|pờ ra ta ma 
arhan|a han 
tokyo|tô ki ô 
verdy|vét đi
safeview|sép veo 
autosafety|au to sép e ty
implant|im pừ lan 
intech|in
arthur|a thờ
o urso|o u sô 
model|mô đồ 
nezha s|ne ha ét
etihad|e ti hát 
kosovo|cô sô vô 
panenka|pa nen ka 
shannon|sen nừn 
curry|cu ri 
g-group|gờ rúp 
gapowork|ga po o 
gpay|pay
vinaxuki|vi na su ki 
hoian|hoi an 
d'or|đê o 
café|cà phê 
chill|chiu
fisker|phi cơ 
richard|ri chát 
gere|ge 
alejandra|a le dan đa 
silva|xin va 
film|phim 
lamsan|lam san 
microsoft|mai cờ rô sóp 
workspace|a pa 
thibaut|thi ba út 
courtois|cu toi 
mishel|mi he 
gerzig|di 
mayweather|may goe dờ 
floyd|phờ loi 
don moore|don mo rơ 
truss|tru 
deck|đớt
seico|sei cô 
merciful|me hu 
noo|nô
kyoka|ka y ô ka 
flora|phờ lo ra 
panorama|pa nô ra ma
mizuki|mi du ki
ohio|ô hi ô
los|lốt 
angeles|ăng dơ lét 
baby|bây bi 
istep-d|i sờ tép đê 
medexpress|me de re 
ksor|cây xoa 
bieng|bi eng 
hacinco|ha xin cô 
revive|re vi ve 
water|oa tờ
nasco|na co 
vacation|vây cây sần 
koto|cô tô 
onsen|on sen 
lottie|lót ti 
brimstone|bờ rim sờ tôn 
dress|đờ rét 
design|đi sai 
impact|im pắc
rankings|ranh kinh 
raiola|rây ô la 
down|đao 
thalassemia|tha la se mi a 
paulo|pau lơ 
dybala|đi ba la 
oriana|ô ri a na 
sabatini|sa ba ti ni 
hpe|hát pê e 
greenlake|re en la ke 
gamuda land|ga mu đa len 
brillant|lan 
celadon|la don 
kylian|kai li ần
gunnar|gun na 
wiegand|uy e gan 
there's|the re ét
hans|han s
glanzer|lan de 
carlsen|ca sen 
magnus|mác nớt 
esports|i sờ pót 
gas-er|ga ơ 
phenikaa|phe ni ca
tetrodotoxin|tê trô đô tô xin 
fumio|phu mi ô 
kishida|ki shi da 
hdbank|hát đê banh 
maya|mây a 
jama|da ma 
jemmia|de mi a
wave|uây 
managed|ma nít dờ 
méridien|mé re di en
medical|me đi cồ 
clinton|cờ lin tơn
stamper|tem pe 
roscosmos|rốt cô mốt 
guiness|ghi nét
gross|gờ rốt 
camping|cêm ping 
opening|o pe
tara|ta ra 
jayne|dây ne 
duplex|đu pờ lớt
celine|xe lin 
dion|đi ông
assunta|a sun ta 
asiad|a si át 
mclaren|mác la ren 
spider|sờ pai đơ 
pathum|pát hum 
united|diu nai tịch
mik|mít
cortesi|co rét si 
bobby|bóp bi 
iii|ba
onyx|ô ních
nicola|ni cô la 
peltz|pe 
amir|a mi 
khan|khan 
nancy|nan si 
pelosi|pe lô si 
fernando|phét nan đô 
alonso|a lon sô 
schlager|la 
yars|dác 
gong|gông
crimes|cờ rim
pwn2own|o 
flybrows|ly ro 
chance|chan 
chanel|cha neo 
vuitton|vui tần 
basic|bây dích 
digibiz|đi bi 
visa|vi da 
business|biu di nít
matichon|ma ti chôn 
choktawee|cho ta e 
promrat|rôm rát 
marc|mác 
knapper|náp pe 
lesley|lét lây 
maxwell|mác sen 
gym|ghim 
lukashenko|lu ca sen cô 
minsk|minh 
anoush|a 
dastgir|da gi 
dualcool|đê u a lờ xê ô ô lờ 
sportage|po ta 
ranger|rên dơ 
ryzen|ri den 
card|cát 
nvidia|en vi đi ây 
geforce|di phót 
rog|róc 
zephyrus|dép phi 
duo|đu ô 
taycan|tay can 
sean|sin
wotherspoon|ót he pon 
cilic|si lích 
marin|ma rin 
rublev|ru le 
holger|ho 
rune|ru ne 
oled|ô lét 
sheryl|se rồ 
sandberg|san bớt 
debit|đe bít 
lviv|vi
worawut|o ra út
okamura|o ka mu ra 
novaland|nô va len 
vinaconex|vi na cô nớt 
tnr|ti en a 
gyun|ghi un 
bangladesh|băng la đét 
uniqlo|iu ni gờ lờ ô  
tadashi|ta da hi 
yanai|da nai 
chilwell|chi e 
s&p|ét en pi 
nutifood|nu ti phút 
dairy|dai ri 
sojo|ét ô di ô 
super|su pơ
cub|cúp 
gray|gờ rây 
eagle|éc gồ 
hispania|hi pa ni a 
kdi|ca đê i 
gran|gờ ran 
signature|xích nây chờ 
reverie|de vơ di 
mindalife|min da líp 
cover|ca vờ 
jeannie|de an ni e 
icar|i xê a rờ
g-dragon|gờ đơ ra gần
hannam|ha nam 
bluescope|bờ lu sờ cốp
activate|ác ti vét 
sloviansk|lo vi an  
dwayne|đê uây 
top gun|tốp gun
maverick|ma vờ rích 
jang nara|dang na da 
stavridis|sờ ta ri di 
tennis|te nít 
mipec|mi pếch
binance|bi nan 
finhay|phi nhây
fintech|phin tếch
sunneva|sun ne va
sundarbans|sun da ban 
bengal|ben dờ 
running|răn ning
ubofood|u bắp ho 
cloud|lao 
trizano|tri da no 
lucas|lu cát 
almeida|sa da 
mega|mê ga 
kick|kích 
movie|mu vi 
lexus|lếch xớt 
co2|xê ô hai
roman|dô man 
clevai|lê vai 
edtech|e
metaverse|me ta ve se 
decentraland|de xe tra lan 
banker|banh cơ 
bibica|bi bi ca 
s-merciful|ét me hu 
cilonmum|lon mum 
premio|de mi o 
will smith|iu mít
dean gorré|đin go ré 
deepfake|de ép pha ke 
saitama|sai ta ma 
kyrylo|ki ri lo 
budanov|bu da no 
financial|phai nen sồ 
rachelle theise|ra che le se 
nyu|en oai diu 
art|át
kengo|ken gô 
nakamura|na ka mu ra 
neuromed|ro me 
kanzogen|dô gen  
gold|gun 
tajikistan|ta di kít tăng 
jasurbek|da su be 
urban|ơ bần 
chernihiv|che ni hi 
daikin|đai kin 
dejan|đề dan 
kulusevski|lu se ki 
eldina ahmic|e di na 
hole|hâu
savanna|sa van na 
tinder|tin đơ 
stinger|sờ tinh gờ 
safety|sa phe ty 
sense|sen 
scargel|ca 
gel|deo 
artura|a tu da 
var|va 
citadines|xi ta đin 
ascott|át cót 
limited|li mít tựt
investment|in vét mừn 
mkhitaryan|mơ hi ta dai ơn 
lopyreva|py re va 
airways|e uây 
karpov|ka po 
powerpoint|pao ờ poi
maps|mép
hyun bin|hy un bin 
mazda3|ma da 
costa|cốt ta 
rica|ri ca 
tonkin|ton kin 
funiki|phu ni ki 
aerospace|a rốp pờ lết 
corporation|cóp pô rây sừn 
deltacron|de tắc ron 
women|ua mèn
alan|a lan 
sergio|séc di ô
pilar|pi la v
rubio|ru bi âu 
ramos|ra mốt
grabmart|ra ma
vinasoy|vi na soi 
fanpage|phan pết 
tucson|tu sơn 
creta|cờ ri ta
crossover|cờ dót âu vờ
krông pắk|cờ rông pắc
millennia|mi len ni a 
western|oét tờn 
volt|von 
caiman|cái man 
xwash|a 
fake|phếch 
tony4men|to ni men 
elliot|eo li ốt 
page|pết 
veston|vét tông 
nuiphao|nui phao 
mining|mai ninh 
streamer|sờ trim mơ 
azov|a dốp
hub|hắp 
imoney|i măn ni 
coco|cô cô 
jambo|dam bo 
precia|de a 
fernanda|phơ nan đa 
lima|li ma 
ciaz|si át 
civic|xi vích
bruce|bờ ru 
willis|uy li 
tiki|ti ki 
genviet|gen vi ét
jeans|din 
lando|lan đô 
norris|no di 
luisinha|lu i si nha 
oliveira|ô li vê ra 
stamford|sờ tam phót 
toucan|can 
doug|đắc 
kammerer|me re 
tiesto|ti e to 
annika|an ni ka 
nude|nuy 
edith|i đít 
lemay|lê may 
sébastian|sẽ bát ti an 
pelletier|pe le ti e 
sameh sidhom|sa me si hon 
carom|ca rôm 
shop|sóp 
apply|ắp lai 
gramlich|dam lích 
philadelphia|phi la đen phi a 
pennsylvania|pen sin va ni a 
sacramento|sa ka ra men tô 
buaksib|bua si 
buriram|bu dam 
lee min ho|li min ho 
yaya|dây a 
toure|tua 
harcus|ha cu 
blade|bờ lết 
miami|mai a mi 
oceanbank|âu sừn banh 
helium-3|he li um 3
blinken|lin ken 
lorient|lo ri en 
rosa|dô sa 
btec|bi tếch 
ieee|ai tríp pồ i 
xplore|lo re
pantsir|pan sơ 
entertain|en te 
kratik|ra ti 
mueang|mu ăng 
nonthaburi|non tha bu di 
co.op|co óp 
betancourt|bê tan 
natalia|na ta li a 
space|sờ pây 
takara|ta ka da 
techsci|tếch ét xi ai
hydrogen|hy đờ dô den 
kangaroo|can ga ru 
bucha|bu cha 
logic|lô dích 
switchblade|sờ uých ơ bồ 
max|mắc 
leaker|le a ke 
shrimpapplepro|rim pắp lép 
bikini|bi ki ni 
h&m|hát và mờ 
domino|đo mi nô 
sport.fr|sờ pót ép rờ 
soleil|xô len 
ichoha|i chô ha 
ekisu|e ki su
tyler|tai lơ 
aerosmith|a e ro mít 
tiger|tai gơ 
paige|pết 
spiranac|pi ra nác 
woods|gút 
blue|bờ lu 
cats|cát 
foden|pho den 
kevin|ke vin
bruyne|bờ ru ni
dova|do va 
opus|o pu 
yaris|da rít 
mazda2|ma da 
evening|i vờ ninh 
auto|au tu 
bliss|bờ lít 
goonew|go ne 
patriot|pa tri ốt 
fastest|pha te 
telecom|te lê côm 
dazed|da de 
avvenire|a ve ni de 
spiritus|pi ri tu 
ethereum|e thơ ri um 
doge|đo 
yoon|y un 
suk-yeol|súc y e o 
thairath|thai rát 
republic|ri pắp lích 
sheen|he en 
marta|ma ta 
barczok|ba do 
computer|com piu tơ 
hattrick|hát trích 
komodo|cô mô đô
testosterone|tét tốt te rôn 
kali|ca li 
tsonga|son ga 
jo-wilfried|dô uy phờ rét
sakura|sa cu da 
hecta|héc ta 
genz|gen 
miwako|mi a 
sajad|sa da 
gharibi|ri bi 
martyn|mác tin 
chôl|chôn 
chnăm|năm 
thmây|mây 
khmer|khơ me 
heidi|hei đi
klum|cờ lăm 
leni|le ni
yodogawa-ku|y o do ga a cu 
plasmacluster|la mát lu te 
orient|ô ri en 
monitor|mo ni tơ 
florida|phờ lo ri đa 
novaworld|no va 
thiet|thi ét 
bola|bô la 
bond|bon 
seymour|si mo 
snowflake|no la ke 
condotel|con đo ten 
imperial|im pe ri en 
plaza|pờ la da 
eintracht|chếch 
us|ớt
trading|trây đinh 
ltd|li mít tựt 
talk|thót
lala beer|la la bia 
club|cờ lắp
service|sơ vít 
fitness|phít nít 
hills|hin 
cash|cát 
naryshkin|na ri sờ kin 
kiddihub|ki di hu 
gakken|ga ken 
fibrosarcoma|phi ro sa co ma 
binz|bin 
championship|cham pừn xíp 
ronnie|ro ni 
o'sullivan|o su li van 
neil robertson|neo rô bét sơn 
kashima|ca si ma 
antlers|an le 
midu|mi du 
buk-m1|búc mờ một 
brunei|bờ ru nây 
jernej|de ne 
kamensek|ka men 
divo|đi vô 
zhang wen|dang uen 
alaska|a lát ca 
clermont|le mon 
imran|im ran 
gea|gê a 
ok|ô cê 
bella|beo la 
hadid|ha đít 
nations|nây sừn 
acet|a xét 
blended|len den 
canvas|can vát 
thamsatchanan|tham sát cha nan 
immune|i mun 
checkpoint|chếch poi 
inhibitors|i ni bi to 
karl|ca da 
nehammer|ne ha me 
jamais|da mai 
contente|con ten te 
dmytro|do 
kuleba|le ba 
mg|mi li gam 
zs|dét ét 
levante|li van tê 
axiom|a si om 
spacex|sờ phây ích 
nole|nôn 
jake|dếch 
sullivan|su li van 
goal|gôn 
check|chếch 
jorginho|giooc di nhô 
catherine|ca thơ rin 
harding|ha đinh
johnathan|dô na than 
cargo|ca gô 
shoptel|hóp te 
sonasea|săn nây si ờ 
harbor|ha bơ 
apea|a pê a 
inspirational|in sờ pi rây sừn nồ 
brent|bờ ren 
movenpick|mu vơ pích 
queenara|que e na 
zalo|da lô
circle|sơ cồ 
cosplay|cót pờ lây 
hansjorg|han do i 
wyss|y 
pleiku|pờ lây cu 
alisher|li dơ
usmanov|út ma nơ vê 
minamino|mi na mi no 
kicks|kích
oleksandr|o le san 
usyk|u si 
joshua|do hua 
bave|ba ve 
touchstone|to ne 
ireland|ai len 
anonymous|a no nơ mớt 
goertek|go e te
davis|đa vít 
kieran|ki rần 
klipspringer|líp di 
iaea|cơ quan năng lượng nguyên tử quốc tế
zaporizhzhia|da po ri hia 
quad|quát 
narendra|na den da 
modi|mô đi 
cas|cớt 
tecco|tếch cô 
pattinson|pa ti sơn 
lifewear|líp he 
agile|a gi le 
data|đa ta 
lithium|li thi um
chaney jones|cha dôn 
counterpoint|te poi
sithongchanh|si hong chanh 
phonethita|pho net hi ta 
italia|i ta li a 
dominic|đo mi nic 
raab|ra a 
baht|bạt 
paing|
takhon|ta khon 
candler|khen đờ 
daily|đây li 
mail|mêu
muhsin|mu sin 
bayrak|bay da 
surimane|su di ma ne 
sendo|sen đỏ
retail|rì têu 
zhitomir|hi to mi 
madonna|ma đô na 
warsaw|vác sa va 
pamela|pa mê la 
anderson|an đét sơn 
tommy|tô mi 
sala|sa la 
ferran|phe dan 
depay|đè pay 
elche|e che 
siberia|si bê ri a 
yakutsk|da 
adchariya|a cha ri da 
mikgroup|mi 
mövenpick|mờ ven píc
ubank|u banh 
bugatti|bu ga ti 
chiron|chi rôn 
nikolai|ni cô lai 
henry|hen ri 
kissinger|ki si 
kennan|ken nan 
monkey|măn ki 
queretaro|que de ta ro 
atlas|át lát 
willem|uy lem 
j&t|di và tê 
express|ích pờ rét 
tuesday|tiu đây 
laura|lau ra 
basuki|ba su ki 
lana|la na 
condor|con đo 
gegenpressing|gen de sing 
anelosimus|a ne lo si mu 
eximius|e xi miu 
tantashev|tan ta hei 
ilgiz|di 
melanie|mê la ni 
perkins|pơ kin 
castrol|cát trôn 
shell|seo 
nord|nót 
stream|sờ trim 
dettol|dét to 
reckitt|déc kít 
midea|mai đi
chery|che di 
krông|cờ rông 
urgently|u ghen ly 
laicity|lai ty 
laigroup|lai
polyp|pô líp 
helicobacter|hê li cô bác tơ 
pylori|py lo di 
oscars|ốt ca 
night|nai 
dylan|đi lừn 
meyer|mây ơ 
teddy|tét đi 
sheringham|sơ rinh ham 
digiworld|đi gi uốt 
piano|pi a nô 
cainiao|cai ni ao 
network|nét uốt 
studio|sờ tiu đi ô 
scopus|sờ co pớt 
jabes|di a bê ét 
salofa oy|sa lóp ha oi 
salocor®|sa lo co 
merryland|me di lan 
olympus|ô lim pớt 
mons|mon 
symphony|sim pho ni 
orchestra|o chét ta 
vus|vớt 
salzburg|san bớt 
co-opbank|co ốp banh 
beer|bia 
etanol|ê ta no 
diesel|đi e den 
vista|vít ta 
local|lâu cồ 
zone|dôn
streaming|sờ trim minh 
mustang|mu sờ tang 
evusheld|e vu he 
gram|gam 
craig|cờ rết 
rachel weisz|ra cheo 
polycan|po li can 
ayuflex|a le 
glory|lo di 
moya|mo da 
diva|đi va 
parisien|pa ri si en 
knock-out|nốc ao 
audi|au đi 
takebe|ta cư be 
tsutomu|tê su tô mu 
julia fox|du lia phóc 
fitobimbi|phi to bim bi 
ferro|phe ro 
c|xê
inaki|i na ki 
pena|pen na 
galatasaray|ga la ta sa dây 
nou camp|nu cam 
coupe|câu pe 
beckinsale|béc kin sa le 
grimes|di me 
andrei|an đờ rây 
sukhovetsky|su kho vét ky 
blues|blue 
flycam|phờ lai cam 
chiraphat|chi ráp hát 
phumchit|phum chít 
challenger|cha len dờ 
ruslan|rút sờ lan 
malinovskyi|ma li no 
aleksey|a lếch si 
miranchuk|mi ran chu 
chubb life|chắp lai phơ 
wyoming|oai ô minh 
behomes|be ho me 
village|vi la 
mastercard|mát tờ cát 
koina|na 
riolo|ri o lo 
feliz|phe li 
fantasy|phan ta si 
pine|phin 
panida|pa ni đa 
barclays|ba cờ lì 
garry|ga di 
tonon|to non 
jussie|du si e 
smollett|mo lét 
coalition|cồ a li sừn 
bolada|bo la da 
cathyn li|cát li 
gymer|me 
akari|a ca di 
crush|cờ dắt 
rivana|ri va na 
bordeaux|bóc đô 
sexy|sếch si 
raptor|ráp tơ 
renaud|de nau 
riqui puig|ri quy pui 
osasuna|o sa su na 
exmicror|e do 
inteco|in te co 
andriy|đờ di 
yarmolenko|a mo len cô 
conlan|con lan 
mirage|mi da 
foxconn|phốc con 
enzyme|en dim 
valentine|va len thai 
jordyn lyne|do ly ne 
mfamily|mờ phem mi ly 
mobifone|mô bi phôn 
a321|a ba hai một
palm|pa 
myna|mi na 
option|óp sừn
optimizer|óp ti mai dơ
kazakhstan|ca dắc tăng
baena|ba e na 
autobahn|au tô bát 
salad|sa lát 
kamila|ca mi la 
valieva|va li e va 
intercode|in te co de 
people's|pi pồ ét 
choice|choi 
bootlace|bê ô te la 
anchilee|an chi le e 
scot-kemmis|sờ cốt kem mi 
lympho|lim pồ 
ibrahim|i bờ ra him 
al-hashimi|an ha hi mi 
al-qurayshi|an cu da hi
santafe|san ta phê
raize|rai de
coupon|câu pôn 
casiquin|ca si quyn 
jr|dây a 
asap|sạp 
hutech|hút tếch
lexi|lê si 
reed|rít 
river|ri vơ 
golden|gôn đần 
urawa reds|u da de 
watabe|oa ta be 
bochum|bo chum 
elanga|e lang ga 
vukadinova|vu ca di no va 
vienergy|vi en ne 
phuket|phu kẹt 
maldives|man đi vơ 
bali|ba li 
kingland|lan 
tuivasa|tui va sa 
derrick|đa rích 
class|cờ lát 
gogh|gốc 
code|cốt 
starbucks|sờ ta bấc 
merson|me son 
osin|ô sin 
connery|con nơ ri 
siswanto|si an to 
yasuhiro|da sư hi rô 
saitoh|sai to 
health|heo 
haivina|hai vi na 
muangthong|mu ang thông 
cantlay|can lay 
mario|ma ri ô 
freelancer|phờ ri len sơ 
unis|u nít 
jarl|da  
riiber|be 
deborah|đờ ba ra  
thaibev|thai be 
sabeco|sa be cô 
sonet|so nét 
nazri|na di 
nasir|na sơ 
jennie|den ni 
logistics|lô dít tích 
corona|cô dô na 
violon|vi ô lông  
d'ingres|đê i de 
chiba|si ba 
yamagata|da ma ga ta 
today|tơ đây 
hwang|hoang 
archegos|an che go 
karthik|ca thi 
sarma|sa ma 
zumwalt|du ma 
greenland|gờ din len 
mariah|ma ri a 
carey|ce ri 
mimosa|mi mô sa 
sophie|sô phi 
smile|sờ mai 
autopilot|au to pi lót 
napoli|na pô li 
dow|đu 
brandcreativity|dan de a ti vi ti 
finance|phai nen 
independent|in di pen đừn 
elantra|ơ lan chờ 
vietracimex|việt trây si mếch 
pitt|pít 
château|te au  
miraval|mi ra va 
shinnyo-en|hin ny o en
veam|vim 
tess|tét 
holliday|hô li đây 
lancaster|len cớt tơ 
luminaire|lu mi nai re 
toshin|to hin 
takashimaya|ta ka hi ma da
artem|a tem 
emelianov|e me li a no 
elbek|e be 
alishov|a li ho
jetson|dét son 
chrissy|cờ rít si 
teigen|gen 
drogba|đờ róc ba 
nantes|nan tét 
breakfast|bờ rếch phớt  
tiffany's|tít pha ni ét 
yunioshi|ni o hi 
canberra|can be da 
arafura|a da hu da 
rené|re ne 
angelil|a li 
andrographolide|an do ráp ho li de 
choong|chông  
sars-cov2|xa xê ô vê hai 
las|lát  
vegas|vê gát 
zingplay|pờ lay 
edexcel|e đếch seo 
winecellar.vn|vê kép i nờ e xê e lờ lờ a dờ việt nam
wedgwood|eo 
tuynel|tuy ne 
social|sâu sồ 
rostov|rô sờ tốp
safari|sa pha ri 
april|ap ri  
banbury|ban bu ri 
valero|va le ro  
pharaoh|pha rao 
alkaviva|an ka vi va 
lazychef|la di chép 
universal|diu ni vơ sơ 
alloy|ơ loi 
mobihome|mo bi ho me 
elemment|e le men  
palazzo|pa la do 
minibar|mi ni ba 
safin|sáp phin 
tasmania|tát ma ni a 
melbourne|meo bơn 
zoe|dét e  
sozo|so do  
bethel|be thồ 
alabama|a la ba ma 
lindsey|lin sây  
pearlman|pe a man 
venus|vê nớt 
weijun|dun 
wolves|âu sờ 
glen|gờ len  
garriff|ga ríp 
harrismith|ha ri mít 
state|sờ tết 
fedex|phe đếch 
sasco|sát cô 
frevola|re vo la 
smartwatch|sờ mát goát 
fadzilah|pha di la 
burkina|bu ki na 
faso|pha so 
gabon|ga bông
metsulfuron|mét su phu ron 
methyl|mét thy 
glyphosate|ho sa te 
zoom|dum 
asa|a sa 
roch|róc
kabore|ka bo de 
vincie|vin e 
maree|ma de  
arnold|ác nô 
winston|uyn sờ tơn 
meagan|mê a gan 
carl|các 
vinson|vin sơn 
lincoln|lin côn 
adele|a đeo 
everland|e vơ lan 
martial|mác ti ờ 
fabrizio|pha ri di ô  
romano|rô ma nô 
lubabul|lu ba bu 
comoros|co mo do 
chaker|cha ke  
alhadhur|a ha hu 
cameroon|cam mơ run 
indiana|in đi a na 
pink|ping 
barbie|ba bi 
frieslandcampina|phờ rai len cam pi na 
pavillon|pa vi lon 
ross|rốt  
carter|ca tơ 
luo|lu o  
guofu|gu óp hu 
rothschild|sô chi 
rene|ren e
meulensteen|len te 
dasavis|da sa vi 
palestine|pa lét tin 
zhou|du
jian|di an  
michella|mi che la  
meier-morsi|mai ơ mô si 
copenhagen|cô pen ha gen 
file|phai 
wellington|goeo linh tơn 
osako|ô sa
ito|i tô
sharing|sha rinh 
taiwan|tai goan  
excellence|e len 
caring|ca 
follower|pho lâu ờ 
irina|i ri na  
shayk|hay 
bradley|bờ rát li  
cooper|cúp pơ
vietbev|vi ét be 
beverage|be vơ rít 
alisson|a li sơn 
tetra|tét ra 
pak|pắc 
office|óp phít 
castia|ca ti a 
lifestyle|lai ph sờ tai 
scholastic|cho la 
aptitude|áp ti tu 
board|boắt
educational|e đu cây sừn nờ  
testing|tét tinh  
made-in|mết in 
indosport|in do po 
mondelez|mon de le 
schwarzenegger|sờ oa den nếch gơ 
hitachi|hi ta chi 
rivale|ri va le 
blogger|bờ lốc gơ 
burj|bơ di  
khalifa|kha li pha 
prayut|pờ ray út  
chan-ocha|chan o cha 
arkansan|a san 
frank|phờ ranh  
rafa|ra pha  
benitez|be ni tét 
minzy|min di 
review|rì viu
gamuda|ga mu đa
xyanua|xy a nua
bolero|bô lê rô
vov|vê ô vê
lavina|la vi na
nicolas|ni cô lát
cage|kết
gamma|gam ma
albert|an bớt
jota|do ta
ca-pô|ca pô
veronika|vê rô ni ca
kathy|ca thy
tivi|ti vi
viet|việt
foods|phút
activision|ách ti vi sừn
lady|lây đi
gaga|ga ga
axit|a xít
indochine|in đô chin
hanoi|hà nội
wi-fi|goai phai
fukuoka|phu cu ô ca
asus|ây sớt
fomo|phô mô
vinasun|vi na săn
vietlott|việt lót
atm|ây ti em
vtc|vê tê xê
Gianni|da ni
Infantino|in phan ti no 
boutique|bu ti 
Seachains|sẽ a 
suni|su ni 
ted|tét
meier|mai ơ 
morsi|mô si 
ebanie|e ba ni e 
Evo|i vô 
Oxfam|ốc pham 
jamie|dêm mi 
Dornan|đô nan 
Sadio|sa đi ô 
Mane|man
Sandia|san đi a 
size|sai
robertson|rô bét sơn 
Hashimi|ha hi mi 
Qurayshi|cu ra di 
haalad|ha la
Bollywood|bô ly út 
Aishwarya|ai sờ oa ri
xiaopeng|si ao pênh 
xuyuan|su 
reece|re 
Zolani|do la ni 
Marali|ma ra li 
Megalodon|mê ga lô đen 
esparza|e pa da 
danielle|da ni eo 
kelly|ke ly 
ITviec|ít vi ét
grab|gờ ráp
Pangong|pang ong 
Tso|tê sô 
Economist|e co no mít
phillippines|phi líp pin
luton|lu tơn 
janet|da net 
CES|sét 
Phayom|pha 
Boonrueang|bom ru ang 
hiroshima|hi rô si ma 
Tonga|tôn ga 
Azalea|da le a
Explorer|ích pờ lo ờ
Xand|san 
Avĩao|a vi o
Steve|sờ ti  
Harvey|ha vi
Tritydo|tri ti do 
Gallagher|ga la gơ 
Mart|mát 
Koja|da
Azmi|ami 
Murad|mu rát
Lloyd|loi 
Austin|ớt tin 
Kuwait|cô oét
Santander|san tan đơ 
Lady|lây đi 
rating|ra tinh 
Delica|de li ca 
pander|pan đơ 
angiosarcoma-|ao da co ma 
Marca|mắc ca
Citigroup|si ti gờ rúp 
Overseas|âu vờ si
mig|míc
Koo|ca ô
Jun|giun
Yup|dắp
Troy|troi 
VnEconomy|vi en e cô no mi 
Abdala|a da la
Fiji|phi di 
phd|pi ét đi 
margin|ma gin
chro|ro
HDMon|mon
Motorkhana|mo to kha na 
Wamaya|a ma da
Gautam|ga út am
Adani|a da ani 
Buk|búc
Pacific|pa si phích
flurona|lu ro na 
Seyfarth|e pha
Godfrey|go
plesetsk|le sét 
Betty|bét ti 
Sameh|sa me 
Sidhom|si hom 
Scream|sờ cờ rim 
edvard|ét vát 
munch|man 
Riqui|ri qui 
Puig|pui
Danielle|da ni eo 
Lloyd|loi 
Hyon|hy on
Chol-hae|choi hây 
jong-un|dông un
Paternoster|pa te no te
photo|phô tô 
V-Stars|vê sờ ta
Gtwill|iu
Postef|po tép 
American|ơ me ri cừn
crumpton|rum ton 
Nick|ních 
Jonas|dô nớt 
Priyanka|ri dan ca 
Chopra|cho pờ ra
Kepa|kê pa 
Arrizabalaga|ri da ba la ga
Katyusha|ca ha 
Baghdad|bát đa 
Vimeco|vi me cô
xander|xan đơ 
schauffele|chau phe le 
Brooks|bờ rúc 
Koepka|ép ca 
pow|pâu
Ngannou|ngan
Francis|phờ ran xít
optimizer|op ti mai dơ 
SolarEdge|so la de
Icardi|i ca di
Wanda|oan đa 
Nara|na ra
Studios|sờ tiu đi ô
Hajime|ha di mây 
Moriyasu|mô ri da su
Selangor|se len go
VSIP-Sembcorp|vê ét i pê sem cóp 
Pattaratida|pát ta ra ti da
Ukraina|u cờ rai na
Alex|a lếch 
Hawke|ha ke
module|mô đun 
Casanova|ca sa no va
Celta|xen ta 
Vigo|vi gô
urso|u so
next|nếch
Kreminna|re mi na 
Tony|tô ni 
Coffey|ca phi
hamas|ha mát
Beam|bim
papangkorn|pa păng 
Lerkchaleampote|le cha le am po te
Honduras|hôn đu rát
Salofa|sa lóp ha 
Origami|ô ri ga mi
TOTO|tô tô
Oliver|ô li vơ
Shihao|hi hao 
wei|uây
Ligue|li gui 
etiene|e ti e ne
body|bo đi
tavares|ta va de
Soleimani|sô lê ma ni
Qassem|sem
sylvester|xin vét tơ 
stallone|sờ ta lôn 
Yangyang|da
Fusion|phu sừn 
Mendes|mên đét
Nicole|ni côn 
Kidman|kít men 
Marco|mác cô 
Serra|se ra
Louvre|lu vờ 
Samothrace|sa mót ra
Kazakhstan|ca dắc tan
Kassym-Jomart|ca do ma 
Tokayev|to ca
consadole|con sa đôn 
sapporo|sa po ro
swat|sờ oát
berth|be
Colleyville|co vi le
moutinho|ti nho 
jica|di ca
Prize|pờ rai 
Thaiholdings|thai ho
Walmart|guôn mát
Muhammed|mu ha me 
Awal|a
Mustapha|mu táp ha 
Wall|uôn
Jessie|dét si 
people|pi pồ
Hateco|ha tê cô
Starlink|ta linh
Activision|ác ti vi sừn
tourist|tua rít
Karli|ca li 
ces|sét
zenbook|den bo
Mohave|mo ha ve
hotel|hâu theo
Tiffany's|típ pha ni ét
itakura|i ta ra 
Wataru|ta ru 
Endo|en do
Naomi|na ô mi 
Huayuan|hua 
Machinery|ma chi ne ri 
Haitian|hai ti an
chaney|cha
Leena|le e na 
Jungjunja|dông dun
TOEIC|tô ích
discoveries|đít ca vơ ri 
Factor|phách tơ
Quacquarelli|qua re li 
Symonds|si mon
Fansipan|phan si păng 
Koffmann|man
temple|tem pô
Jenna|den na 
Norodom|ro đôm
HelloBacsi|he lo bác si
Hello|hê lô
Kathy|ca thi 
Hochul|ho chu
Umida|u mi da 
Nazarova|da ro va
Oakland|oa lan
connect|con nếch
connected|con nếch tựt
generation|gien nơ rây sừn
tracking|trách kinh
esim|e sim
chipset|chíp sét
platform|pờ lát phom
module|mô đun
identify|ai đen ti phai
embedded|em bét đựt
contact|con tách
location|lô cây sừn
co-location|cô lô cây sừn
meet|mít
edu|ê đu
mobica|mô bi ca
mobiedu|mô bi ê đu
mobimeeting|mô bi mít ting
econtract|y con trách
siptrunk|síp trăn
connectivity|con nếch ti vi ti
management|ma nít mừn
SDK|ét đi kây
mobiwifi|mô bi oai phai
mobifiber|mô bi phai bơ
mbiz360|mờ bít ba sáu mươi
massive|mây síp
liveclass|lai cờ lát
token|tốc kừn
usb|u ét bi
kpi|kây pi ai
school|sờ cun
mschool|em sờ cun
iot|ai ô ti
partnership|bát nờ síp
project|bờ rô dếch
base|bây
station|sờ tây sừn
bluetooth|bờ lu tút
application|áp li cây sừ
backend|bách en
frontend|phờ ron en
things|thinh
smarthome|sờ mát hôm
smartsite|sờ mát sai
aiot|ây ai ô ti
api|ây pi ai
livechat|lai chát
course|cót
courses|cót sịt
fm|ép em
load|loát
upload|ắp loát
portal|bo tồ
moocs|móc
subscription|sắp cờ ríp sừn
hotline|hót lai
mbiz|em bít
meeting|mít tinh
time|tham
sales|sêu
release|ri lít
stack|sờ tách
artificial|a ti phi sồ
balance|ba lừn
balancing|ba lừn xinh
scale|sờ kêu
scaling|sờ kêu linh
update|ắp đết
upgrade|ắp gờ rết
rolling|rôn linh
schedule|sờ két đồ
scheduling|sờ két đua linh
rule|ru
engine|en gin
beta|bê ta
cgv|xê gờ vê
avenger|ơ ven dờ
deadpool|đét bun
wolverine|gua vơ rin
x-men|ích men
underground|ăn đờ gờ rao
tv|ti vi
input|in bút
output|ao bút
calendar|ca len đờ
airflow|e phờ lâu
dev|đép
engineer|en di nia
tester|tét tơ
devops|đép óp
mlops|mờ lờ óp
motion|mâu sừn
wow|gao
logan|lô gừn
algeria|an giê ri
grenada|gờ rê na đa
nevada|nê va đa
oregon|ô rê gừn
corp|cọp
upcom-index|ắp com in đếch
gaza|ga da
chatgpt|chát di pi ti
openAI|âu pừn ây ai
byte|bai
bytedance|bai đen
bit|bít
level|le vồ
natri|nát tri
wibu|guy bu
normalize|nom mờ lai
tokenize|tốc kừn nai
batch|bát
milo|mi lô
lebron|lê bờ ron
levis|lì vai
carhartt|ca hạt
drive|đờ rai
ultra|un tra
ultraview|un tra viu
teamview|tim viu
snapdragon|sờ náp đờ ra gừn
mediatek|mê đi a tếch
gotek|gô tếch
beamin|bê min
triton|trai từn
program|pờ ro gờ ram
core|co
docker|đốc kơ
visual|vi sùa
visualize|vi sùa lai
generative|gien nơ rây típ
inference|in phơ rừn
paper|pây pờ
notion|nâu sừn
static|sờ ta tíc
dynamic|đai na míc
terminal|tơ mi nồ
linux|lai nắc
ubuntu|u bun tu
centos|xen ô ét
linkedln|linh kin
benzen|ben den
dataset|đa ta sét
transfer|tran phơ
background|bách gờ rao
finetune|phai tun
tutorial|tu tô ri ồ
idiom|i đi ừm
soundcloud|sao cờ lao
ghana|ga na
graph|gờ ráp
ethiopia|ê thi ô pi a
angola|ăng gô la
libya|li bi
tunisia|tuy ni di
madagascar|ma đa gát ca
somalia|sô ma li
uganda|u gan đa
mozambique|mô dăm bích
zimbabwe|dim ba buê
zambia|dăm bi a
mali|ma li
senegal|sê nê gan
gabon|ga bông
guinea|ghi nê
sahara|sa ha ra
liban|li băng
yemen|i ê men
kyrgyzstan|ki dít tan
georgia|gieo gi a
armenia|a me ni a
bahrain|ba ranh
estonia|ét tô ni a
luxembourg|lúc xem bua
Malta|man ta
monaco|mô na cô
latvia|lát vi a
slovania|sờ lô va ni a
marino|ma ri nô
peru|pê ru
panama|pa na ma
paraguay|pa ra goay
uruguay|u ru goay
chile|chi lê
guyana|guy a na
caribe|ca ri bê
caribbe|ca ri bê
bahamas|ba ha mát
noc|nóc
gemini|de mi nai
tencent|ten xen
macao|ma cao
hongkong|hồng công
hong kong|hồng công
kong|công
godzilla|gót di la
git|ghít
github|ghít hắp
gitlab|ghít láp
bash|bát
hard|hát
gmail|gờ meo
outlook|ao lúc
syntax|sin tắc
regex|ri gếch
atalanta|át ta lan ta
fiorentina|phi ô ren ti na
olympiacos|ô lim pi a cốt
fenerbahce|phê nê ba chê
porto|pót tô
benfica|ben phi ca
palmeiras|pan mê rát
pantheon|pan thê ôn
cuda|cu đa
cookie|cúc ki
magazine|ma ga din
blancos|bờ lan cốt
true|tru
deluxe|đì lắc
gogi|gô ghi
kichi|ki chi
kpub|cây bắp
gate|gết
haidilao|hai đi lao
manwah|man goa
manga|man ga
speaker|sờ pích cờ
train|trên
training|trên ninh
jupyter|du pi tơ
demo|đê mô
config|con phích
security|se kiu ri ti
hardware|hát goe
azure|a dua
edge|ét
writing|goai tinh
listening|lít sừn ninh
reading|rít đinh
bakery|bây cơ ri
pickleball|bích cồ bôn
fold|phâu
jeep|díp
flip|phờ líp
aid|ết
recharge|rì chạc
soobin|su bin
order|o đờ
liquid|li quít
paint|pên
paints|pên
control|con trôn
panel|pa neo
bug|bấc
debug|đì bấc
spin|sờ pin
rotate|rô tết
audio|au đi ô
pipeline|pai lai
pretrain|pờ ri trên
pretrained|pờ ri trên
embeddding|em bét đinh
detection|đi tếch sừn
recognition|ri cót ni sừn
classification|cờ lát si phi cây sừn
classifier|cờ lát si phai ờm
multiple|mun ti pồ
support|sắp bót
contribute|con tri biu
contribution|con tri biu sừn
domain|đô mên
cluster|cờ lắt tơ
source|suộc
open-source|âu pừn suộc
doc|đóc
setup|sét ắp
version|vơ sừn
overlap|âu vờ láp
verify|ve ri phai
custom|cớt từm
sponsor|sờ pon sờ
install|in tồ
request|ri quét
frame|phờ rêm
tool|tun
toolkit|tun kít
title|tai tồ
system|sít từm
main|mên
banner|ban nờ
content|con ten
string|sờ trinh
case|cây
number|năm bờ
unit|u nít
florentino|phờ lo ren ti nô
perez|pe rét
per|pơ
enzo|en dô
zidane|di đan
martinez|ma ti nét
east|ít
south|sao
street|sờ truýt
leopard|leo pát
panther|pan thờ
shirt|sớt
tshirt|ti sớt
tissot|tít sớt
polyester|po ly ét te
cotton|cốt tông
nylon|ni lon
jaguar|gia gua
relax|re lắc
fit|phít
photo|phô tô
lazada|la da đa
rolex|rô lếch
hublot|húp lót
vacheron|va chê rông
constantin|con tăng
patek|pa tếch
philippe|phi líp
seiko|sai cô
copilot|cô pai lớt
casio|ca si ô
oris|ô rít
cartier|ca ti ơ
omega|ô mê ga
piaget|pi a ghết
hermes|hơ mẹt
gucci|gu chì
dior|đì o
raymond|rây mon
weil|gêu
rado|ra đô
longines|long gin
prada|pờ ra đà
tudor|tu đô
mille|mi lê
tagheuer|tác hêu ơ
tag|tác
mido|mi đô
hamilton|ha min từn
bvlgari|ban go rì
zenith|de nít
bulova|bu lô va
montblanc|mon bờ lác
maurice|mau rít
lacroix|lác roi
timex|tham mếch
burberry|bơ be ry
calvin|ca vin
klein|cờ lai
balenciaga|ba len xi a ga
adidas|a di đát
nike|nai
givenchy|gi ven chi
versace|vơ sạc chề
valentino|va len ti nô
laurent|lau rừn
ralph|ráp
decor|đê co
mcm|em xi em
acecook|ây cúc
aeon|i on
bigc|bích xi
vivi|vi vi
infinity|in phi ni ti
genesis|gie ne sít
acura|a cu ra
lotus|lo tớt
dodge|đót
cadillac|ca đi lắc
lykan|ly can
hyper|hai pơ
isuzu|i su du
chevrolet|che vô lét
fiat|phi át
bentley|ben lì
maserati|mát sê ra ti
alfa|an pha
alpha|an pha
renault|rê nôn
skoda|sờ cô đa
subaru|su ba ru
daihatsu|đai hát su
chrysler|cờ rít lờ
cherry|che ri
chery|che ri
mini|mi ni
lynk&co|lin en cô
pagani|pa ga ni
buick|bu ích
lancia|lan xi a
haval|ha van
howo|hô vô
thaco|tha cô
dongfeng|đông pheng
hino|hi nô
byd|bi goai đi
hummer|hăm mơ
vinmart|vin mát
mic|mích
micro|mai cờ rô
airmax|e mắc
rag|rác
senior|si ni ờ
adviser|ất vai sờ
advisor|ất vai sờ
master|mát tơ
smartcity|sờ mát xi ti
oceanpark|âu sừn pắc
point|poi
skylake|sờ kai lếch
metropolis|mê trô pô lít
notepad|nốt pát
riot|rai ớt
xbox|ích bóc
playstation|pờ lây tây sừn
alphabet|an pha bét
beta|bê ta
metal|mê tồ
metals|mê tồ
jim|dim
jimny|dim ni
sensing|sen sinh
quattro|quát trô
x-drive|ích đờ rai
4matic|pho ma tíc
skyactiv|sờ kai ách típ
active|ách típ
doraemon|đô ra ê mon
nobita|nô bi ta
xuka|xu ka
shizuka|si du ka
xeko|xê cô
chaien|chai en
dekhi|đê khi
jordan|gio đan
bavaria|ba va ri a
snack|sờ nách
union|iu ni ừn
pizza|pi da
company|com pa ni
callbot|côn bót
chatbot|chát bót
genai|gien ây ai
toy|thoi
buddy|bất đi
machine|mơ sin
deep|đíp
summit|săm mít
phillipines|phi líp pin
birmingham|bơ minh ham
wembley|goem bờ li
x|ích
whatsapp|goát áp
mac|mác
imac|ai mác
steve|sờ típ
wi-fi|goai phai
advance|ất van
find|phai
viber|vai bơ
telegram|te le gờ ram
philip|phi líp
lane|lên
embark|em bác
beyond|bi on
elvis|eo vít
beatlemania|bít tờ mây ni a
lighthouse|lai hau
fitzpatrick|phít pa trích
arizona|a li dô na
wisconsin|guýt con sừn
doug|đấc 
sosnik|sâu ních
kamala|ca ma la
rina|ri na
shah|sa
dan|đan
kanninen|ca ni nen
reisner|rai nơ
vance|ven
FiveThirtyEight|phai thớt ti ết
brian|bờ rai ừn 
hughes|hiu
dili|đi li
francis|phờ lan sít
matteo|ma teo
tasitolu|ta si tô lu
teresa|tê rê sa
murdoc|mơ đóc
wales|goeo
trobe|chốp
queensland|quyn len
sturt|sờ tút
wollongong|u lâng gon
curtin|cơ tin
cowan|cao ừn
griffith|gờ ri phíp
macquarie|ma qua li
england|ing lừn
deakin|đi kin
darwin|đác uyn
flinders|phờ lin đờ
monash|mô nát
adelaide|a đơ lây
sunshine|săn sai
coast|cốt
notre|nô chờ
dame|đam
clare|cờ le
mccaul|mác côn
arlington|a linh tơn
gregory|gờ le go li
meeks|mích
al-qaeda|an que đa
caspi|ca sờ pi
ii|hai
azerbaijan|a déc bai dan
barbados|bác ba đốt
belize|bê li xê
benin|bê nanh
bhutan|bu tan
bosnia|bốt ni a
herzegovina|héc dê gô vi na
botswana|bốt xoa na
burkina faso|buốc ki na pha sô
Burundi|bu run đi
cape verde|cáp ve
chad|sát
cyprus|síp
czech|séc
djibouti|gi bu ti
el salvador|en xan va đo
ghana|ga na
grenada|gờ rê na đa
guyana|guy a na
haiti|hai ti
hungary|hung ga ri
lebanon|li băng
lesotho|lê sô thô
liberia|li bê ri a
malawi|ma la uy
marshal|mác san
namibia|nam mi bi a
nauru|nau ru
nicaragua|ni ca ra goa
niger|ni giê
nauy|na uy
palau|pa lau
papua|pa pua
rwanda|ru an đa
nevis|ne vít
kitts|kít
lucia|lu xi a
vincent|vin xen
grenadines|gờ re nơ đin
samoa|xa moa
marino|ma ri nô
seychelles|xây sen
sri lanca|xờ ri lan ka
surinam|xu ri nam
tanzania|tan da ni a
togo|tô gô
tonga|tôn ga
trinidad|tri ni đát
tobago|tô ba gô
tuvalu|tu va lu
vanuatu|va nua tu
Montréal|môn rê an
Toronto|tô rôn tô
Québec|quê béc
Vancouver|van cu vơ
beijing|bắc kinh
Macau|ma cao
Shanghai|thượng hải
Prague|pờ ra ha
Praha|pừ ra ha
Cairo|cai rô
nile|nin
suez|xuy ê
helsinki|hen xi ki
marseille|mác xây
hamburg|ham buốc
hannover|han nô vơ
münchen|muy ních
munchen|muy ních
athens|a then
reykjavík|rây ki a vích
delhi|đê li
jakarta|gia cắc ta
java|gia va
palembang|pa lem bang
tehran|tê hê ran
dublin|đớp bờ lin
jerusalem|giê ru sa rem
genoa|giê noa
honshu|hôn su
kyoto|ki ô tô
nagasaki|na ga sa ki
okinawa|ô ki na oa
yokohama|ô kô ha ma
kansai|can sai
sendai|sen đai
senkaku|sen ca cu
shikoku|si cô cu
Vientiane|viêng chăn
Luang Phrabang|luông pha băng
Rabat|ra bát
Penang|pê nang
Yangon|gian gun
St. Petersburg|xanh pê téc bua
Vladivostok|vờ la đi vô sờ tốc
Cape Town|kếp tao
Incheon|in chơn
busan|bu san
Daegu|đê gu
Geneva|giơ ne vơ
Chiang Mai|chiềng mai
Istanbul|ít tan bun
Baltimore|ban ti mo
Boston|bốt sờ tơn
Chicago|chi ca gô
Detroit|đì choi
Harlem|ha lem
Honolulu|hô nô lu lu
Orleans|ô lân
Hawaii|ha oai
Phnompenh|phờ nôm bênh
Napoleon|na pô lê ông
Robinson|rô bin sơn
Colombo|cô lôm bô
Rhodes|rốt
peso|pê sô
hamamatsu|ha ma mát su
Yoko|ô kô
Tateoka|ta tê ô ka
Waseda|goa sê đa
Yagi|gia ghi
basa|ba sa
Husain|hát sa in
Dickson|đích sơn
Mohamad|mô ha mét
Zorab|dô ráp
Rafah|ra pha
Samar|sa ma
Action|ách sừn
Minnesota|mi ne sô ta
Childless|chai lít
Swifties|sờ guýp ti
Tennessee|te nơ si
Phil|phiu
Bosnia|bốt ni a
Herzegovina|héc dê gô vi na
Andorra|an đô ra
Gibraltar|gi ran ta
Gambia|gam bi a
Bissau|bít xao
Mauritania|mô ri ta ni
Réunion|re uy ni ông
Bermuda|béc mu đa
Aruba|a ru ba
Guatemala|goa tê ma la
Guam|goam
Arizona|a ri rô na
Northern|nót thừn
Kennedy|ke nơ đi
Aldean|a đin
Billy|bin li
Cyrus|sai rớt
Rio|ri ô
Grande|gờ ran đê
Adams|a đam
Allen|a len
Atkinson|át kin sơn
Bailey|bai li
Baker|bây cơ
Ball|bô
Barker|ba cơ
Barnes|ban
Bell|beo
Bennett|be nít
Booth|bút
Bradley|bờ rát li
Brown|bờ rao
Burton|bơ từn
Butler|bát lơ
Campbell|cam beo
Chapman|cháp mừn
Clarke|cờ lác
Cole|câu
Collins |co lừn
Corbyn|co bin
Davidson|đây vít sơn
Davies|đây vi
Dawson|đo sơn
Dixon|đích sơn
Edwards|ét guốt
Elliott|e li ớt
Evans|e vừn
Fisher|phít sờ
Fletcher|phờ lét chờ
Foster|phốt tơ
Gibson|gíp sơn
Graham|gờ ra ham
Grant|gờ ran
Griffiths|gờ ri phíp
Hall|hô
Harrison|ha ri sơn
Holmes|hôm
Howard|ho guốt
Hunt|hăn
Hunter|hăn tơ
Jenkins|gien kin
Johnston|giôn từn
Kelly|ke ly
Knight|nai
Lawrence|lau ren
Lee|li 
Lewis|lu ít
Marshall|mác san
Matthews|mát thiu
McDonald|mác đô nan
Mitchell|mít chờ
Moore|mo
Morgan|mo gừn
Morris|mo rít
Murray|mơ rây
Owen|ô oen
Palmer|pam mơ
Parker|pác cơ
Payne|pây nơ
Pearce|pia
Pearson|pia sừn
Perry|pe ri
Powell|pao ồ
Price|pờ rai
Reid|rít
Reynolds|re nồ
Richards|ri chát
Roberts|rô bớt
Rogers|rô giơ
Rose|râu
Russell|rút seo
Saunders|son đơ
Shaw|so
Simpson|sim sơn
Spencer|sờ pen sơ
Stevens|sờ ti vừn
Stewart|sờ tiu ớt
Thomas|thô mát
Walker|goắc cơ
Walsh|goát
Ward|guốt
Watson|goát sơn
Watts|goát
Webb|goép
Webster|goép tơ
West|goét
White|goai
Wilkinson|guyn kin sơn
Williamson|guy li am sơn
Wilson|guyn sơn
Wood|út
Wright|rai
Siena|si e na
one|oăn
two|tu
three|thờ ri
six|xích
seven|se vừn
eight|ết
eleven|i le vừn
twelve|thoeo
Adela|a đê la
Adele|a đeo
Adelia|a đê li a
Alice|a lít
Artemis|a te mít
Almira|an mi ra
Alva|an va
Bertha|be tha
Briona|bờ ri ô na
Clara|cờ la ra
Cleopatra|cờ lê ô pát tra
Donna|đô na
Doris|đô rít
Elysia|e li si a
Florence|phờ lo ren
Freya|phờ rây a
Gladys|gờ lát đi
Gloria|gờ lo ri a
Gwyneth|guyn nít
Helga|heo ga
Juno|giu nô
Ladonna|la đô na
Martha|ma tha
Meliora|me li ô ra
Mirabel|mi ra beo
Orla|o la
Pandora|pan đô ra
Phoebe|phi bi
Regina|re gi na
Una|u na
Xavia|xa vi a
Amanda|a man đa
Ariel|a ri eo
Bonnie|bo ni
Cara|ca ra
Daisy|đây di
Diana|đi a na
Elaine|ơ lên
Ellie|e li
Fiona|phi ô na
Hannah|ha na
Hera|hê ra
Iris|ai rít
Jade|dết
Jena|giê na
Joy|choi
Juliet|giu li ét
July|giu lai
May|mây
Mia|mi a
Sophia|sô phi a
Stella|sờ tê la
Sunny|săn ni
Vivian|vi vi an
Anna|a na
Annabelle|a na beo
Chloe|cờ lâu i
Elizabeth|ê li da bét
Jessica|dét si ca
Joanna|giô an
Katherine|ca thơ rin
Sally|sa li
Selena|sê lê na
Zelda|deo đa
Ivy|ai vi
mr|mít tờ
mrs|mít si
